abartig	negative	-1
Abart	negative	-0.7
abbauen	negative	-0.7
Abbau	negative	-0.7
Abbau	negative	-1
abberufen	negative	-0.7
Abbitte	positive	0.7
Abbruch	negative	-1
abenteuerlich	positive	0.7
Abenteuerlust	positive	1
abergläubisch	negative	-0.7
aberwitzig	negative	-1
Abfallbeseitigung	negative	-1
Abfallentsorgung	negative	-1
Abfälligkeit	negative	-1
abfällig	negative	-1
Abfallwirtschaft	negative	-1
abfertigen	negative	-1
Abfeuern	negative	-1
Abgang	negative	-1
abgebrannt	negative	-0.7
Abgebrühtheit	negative	-1
abgebrüht	negative	-1
abgedreht	negative	-1
Abgedroschenheit	negative	-1
abgehärtet	positive	0.7
abgehoben	negative	-0.7
abgeklärt	positive	0.7
abgeklärt	positive	1
abgemagert	negative	-0.7
abgemergelt	negative	-0.7
Abgeneigtheit	negative	-1
abgerissen	negative	-1
Abgeschiedenheit	negative	-0.7
Abgeschmacktheit	negative	-1
Abgespanntheit	negative	-0.7
abgespannt	negative	-1
Abgestumpftheit	negative	-1
abgezehrt	negative	-0.7
abgezockt	negative	-1
abgründig	negative	-1
abhalftern	negative	-1
Abhängigkeit	negative	-0.7
Abhängigkeit	negative	-1
abhängig	negative	-1
Abhärtung	positive	0.7
Abholzung	negative	-1
abkanzeln	negative	-1
Abkanzelung	negative	-1
abkapiteln	negative	-1
Abkapselung	negative	-0.7
Abknallen	negative	-0.7
ablassen	positive	0.7
ablehnend	negative	-1
ablehnen	negative	-0.7
ablehnen	negative	-1
Ablenken	negative	-1
Ablenkung	negative	-1
ablinken	negative	-0.7
abmachen	positive	0.7
abmühen	negative	-1
Abneigung	negative	-1
Abnutzung	negative	-1
Abnützung	negative	-1
Abnutzungserscheinung	negative	-1
abplagen	negative	-1
abrackern	negative	-1
abreagieren	negative	-1
abrechnen	negative	-1
Abrechnung	negative	-1
Abreibung	negative	-1
abringen	negative	-1
Abriss	negative	-1
Abriß	negative	-1
Abrundung	positive	0.7
Abrüstung	positive	0.7
Abrüstungsgespräch	positive	0.7
Abrüstungsverhandlung	positive	0.7
absagen	negative	-1
abschalten	positive	0.7
Abschätzigkeit	negative	-1
abschätzig	negative	-1
abscheulich	negative	-1
Abscheu	negative	-1
abschieben	negative	-1
Abschiebung	negative	-1
Abschießen	negative	-0.7
Abschießen	negative	-1
Abschlachten	negative	-0.7
Abschlachten	negative	-1
Abschlachtung	negative	-0.7
Abschlachtung	negative	-1
abschlaffen	negative	-1
abschlagen	negative	-0.7
abschließen	positive	0.7
Abschotten	negative	-0.7
Abschottung	negative	-0.7
abschrecken	negative	-1
Abschreckung	negative	-0.7
Abschreckungsmaßnahme	negative	-0.7
abschürfen	negative	-0.7
Abschürfung	negative	-0.7
Abschuss	negative	-0.7
Abschuß	negative	-0.7
Abschuss	negative	-1
Abschuß	negative	-1
Abschweifung	negative	-0.7
abschwellen	positive	0.7
absegnen	positive	0.7
Absichtlichkeit	negative	-0.7
Absolution	positive	0.7
absolut	positive	0.7
absonderlich	negative	-1
Absonderung	negative	-0.7
absorbieren	negative	-0.7
Abspannung	negative	-0.7
abspeisen	negative	-1
absprechen	negative	-0.7
absprechen	positive	0.7
absteigen	negative	-0.7
absterben	negative	-0.7
Abstieg	negative	-1
abstinent	positive	0.7
abstoßend	negative	-1
abstoßen	negative	-1
abstreiten	negative	-0.7
abstrus	negative	-1
Abstumpfung	negative	-1
Absturzursache	negative	-0.7
absurd	negative	-1
Abszess	negative	-1
abtöten	negative	-0.7
abtöten	negative	-1
Abtragung	negative	-1
abtrotzen	negative	-1
abtrünnig	negative	-1
abtun	negative	-0.7
aburteilen	negative	-1
abwägend	positive	0.7
abwählen	negative	-0.7
abwartend	negative	-1
Abwärtstrend	negative	-1
Abwasserentsorgung	negative	-1
abwechslungsreich	positive	1
abwehren	negative	-0.7
Abwehrkräfte	positive	0.7
abweichend	negative	-1
abweisend	negative	-1
abweisen	negative	-0.7
abweisen	negative	-1
abwenden	positive	1
abwerben	negative	-0.7
abwiegeln	negative	-1
Abwiegelung	positive	0.7
abwimmeln	negative	-1
abwinken	negative	-0.7
abwürgen	negative	-1
achtbar	positive	1
ächten	negative	-1
achten	positive	1
achtgeben	negative	-1
Acht_geben	negative	-1
achthaben	negative	-1
Acht_haben	negative	-1
achtlos	negative	-0.7
achtsam	positive	0.7
Ächtung	negative	-1
Ächzen	negative	-0.7
ächzen	negative	-1
ackern	negative	-0.7
Adaptivität	positive	0.7
adäquat	positive	1
adelig	positive	0.7
adeln	positive	0.7
Aderlass	positive	0.7
Aderlaß	positive	0.7
adlig	positive	0.7
adrett	positive	1
Affekthandlung	negative	-0.7
affektiert	negative	-1
Affekttat	negative	-0.7
affig	negative	-1
Affinität	positive	1
Affront	negative	-1
Agententätigkeit	negative	-0.7
Aggression	negative	-1
Aggressivität	negative	-1
aggressiv	negative	-1
agil	positive	0.7
Agitation	negative	-0.7
Agitprop	negative	-0.7
Agonie	negative	-0.7
Agoraphobie	negative	-1
Agrarreform	positive	1
ahnden	negative	-1
Ahndung	negative	-1
aidskrank	negative	-1
Aids	negative	-1
AIDS	negative	-1
akklimatisieren	positive	0.7
Akne	negative	-0.7
akribisch	positive	0.7
Aktenvernichtung	negative	-1
Aktiva	positive	0.7
aktivierend	positive	0.7
aktivieren	positive	0.7
aktiv	positive	0.7
aktiv	positive	1
Aktualisierung	positive	0.7
Akuratheit	positive	1
akzeptabel	positive	1
akzeptieren	positive	0.7
akzeptieren	positive	1
alarmierend	negative	-1
alarmieren	negative	-1
alert	positive	1
Alkoholabhängigkeit	negative	-1
Alkoholeinfluss	negative	-1
Alkoholeinfluß	negative	-1
Alkoholgenuss	negative	-1
Alkoholgenuß	negative	-1
Alkoholismus	negative	-1
Alkoholkonsum	negative	-1
Alkoholmissbrauch	negative	-1
Alkoholmißbrauch	negative	-1
Alkoholrausch	negative	-1
Alkoholsucht	negative	-1
allein	negative	-0.7
Alleinsein	negative	-0.7
Allergie	negative	-1
Allgemeingültigkeit	positive	0.7
Allianz	positive	0.7
allmächtig	positive	1
allwissend	positive	0.7
alptraumartig	negative	-1
alptraumhaft	negative	-1
Altbausanierung	positive	0.7
Altbausanierung	positive	1
altbewährt	positive	1
altehrwürdig	positive	1
Altenbetreuung	negative	-1
Altersschwäche	negative	-0.7
altklug	negative	-1
Altlastensanierung	positive	0.7
Altlastensanierung	positive	1
Altruismus	positive	1
altruistisch	positive	1
ambitioniert	positive	0.7
Amnesie	negative	-1
Amoklauf	negative	-0.7
Amtshilfe	positive	0.7
Amtsmissbrauch	negative	-0.7
Amtsmißbrauch	negative	-0.7
Amtsmissbrauch	negative	-1
Amtsmißbrauch	negative	-1
amüsant	positive	0.7
amüsieren	positive	1
Anämie	negative	-1
anämisch	negative	-1
anarchisch	negative	-1
anarchistisch	negative	-1
anbiedernd	negative	-0.7
anbiedern	negative	-1
Anbiederung	positive	1
anblaffen	negative	-1
anblasen	negative	-1
anbölken	negative	-1
anbrüllen	negative	-1
andächtig	positive	0.7
andersartig	negative	-1
anderslautend	negative	-1
anders	negative	-1
androhen	positive	1
Androhung	negative	-1
anekeln	negative	-1
anerkannt	positive	1
anerkennen	positive	0.7
anerkennen	positive	1
anfahren	positive	0.7
Anfälligkeit	negative	-0.7
anfällig	negative	-0.7
Anfall	negative	-0.7
Anfall	negative	-1
anfauchen	negative	-1
anfechtbar	negative	-0.7
anfechten	negative	-1
anfeuern	positive	1
anflunkern	negative	-1
anfreunden	positive	0.7
angeben	positive	0.7
Angeberei	negative	-1
angeberisch	negative	-1
angeblich	negative	-1
Angebot	positive	0.7
angebracht	positive	1
angeheitert	negative	-1
angekündigt	positive	0.7
angemeldet	positive	0.7
angemessen	positive	1
angenehm	positive	0.7
angenehm	positive	1
Angeregtheit	positive	0.7
angeregt	positive	1
angesagt	positive	0.7
angesäuselt	negative	-1
Angeschlagenheit	negative	-0.7
angeschlagen	negative	-0.7
angesehen	positive	1
angesoffen	negative	-1
angespannt	negative	-0.7
angestammt	positive	1
angetörnt	negative	-0.7
angetrunken	negative	-1
angeturnt	negative	-0.7
angreifbar	negative	-0.7
angreifen	negative	-1
Angriff	negative	-1
Angriffskrieg	negative	-1
angriffslustig	negative	-1
Angriffslust	negative	-1
ängsten	negative	-1
angsterregend	negative	-1
Angst_erregend	negative	-1
angstfrei	positive	1
ängstigen	negative	-1
Ängstlichkeit	negative	-1
ängstlich	negative	-0.7
angstlos	negative	-0.7
Angst_machen	negative	-1
Angst	negative	-1
Angstneurose	negative	-1
angstvoll	negative	-0.7
anhängen	negative	-1
Anhebung	positive	0.7
anherrschen	negative	-1
animieren	positive	1
anklagen	negative	-1
anknacksen	negative	-0.7
anknurren	negative	-1
ankreiden	negative	-1
anlabern	negative	-1
Anlagebetrug	negative	-0.7
Anlagebetrug	negative	-1
anlasten	negative	-1
anlügen	negative	-1
anmachen	negative	-1
anmahnen	negative	-1
anmaßend	negative	-1
anmaßen	negative	-0.7
anmutig	positive	1
Anmut	positive	1
Annehmlichkeit	positive	0.7
anöden	negative	-1
anormal	negative	-1
Anpassungsbedarf	negative	-1
Anpassungsfähigkeit	positive	0.7
anpassungsfähig	positive	1
Anpassungsvermögen	positive	0.7
anpöbeln	negative	-1
anprangern	negative	-1
anpreisen	positive	1
anquatschen	negative	-1
Anraten	positive	1
anregend	positive	0.7
anregen	positive	0.7
Anreichern	positive	0.7
Anreicherung	positive	0.7
anrüchig	negative	-1
anrühren	positive	0.7
Anschlag	negative	-0.7
anschmieren	negative	-1
anschnauben	negative	-1
anschnauzen	negative	-1
anschreien	negative	-1
anschuldigen	negative	-1
anschwärzen	negative	-1
ansehnlich	positive	1
anspornen	positive	1
ansprechbar	positive	0.7
ansprechend	positive	0.7
anspucken	negative	-1
anstacheln	negative	-1
anständig	positive	1
anstandslos	negative	-1
anstecken	negative	-0.7
anstößig	negative	-1
anstrengen	negative	-1
anstrengungslos	positive	0.7
Anteilnahme	positive	1
antiautoritär	positive	0.7
Antipathie	negative	-1
antisemitisch	negative	-1
Antrag	positive	0.7
antreiben	positive	0.7
Antrieb	positive	0.7
Antrittsbesuch	positive	0.7
antun	negative	-0.7
anvertrauen	positive	0.7
Anwendung	positive	0.7
anwidern	positive	1
anzeigen	negative	-0.7
anziehend	positive	0.7
anziehend	positive	1
anziehen	positive	0.7
anzischen	negative	-1
anzweifeln	negative	-1
apart	positive	1
Apathie	negative	-1
apathisch	negative	-1
Apologie	positive	0.7
Appeal	positive	1
appetitlich	positive	1
Approbation	positive	1
Arbeiteraufstand	negative	-0.7
arbeitsam	positive	0.7
Arbeitserlaubnis	positive	1
arbeitsfähig	positive	1
Arbeitsfreude	positive	0.7
arbeitsfreudig	positive	0.7
Arbeitskampf	negative	-0.7
Arbeitslosenanteil	negative	-0.7
Arbeitslosenrate	negative	-0.7
Arbeitslosenzahl	negative	-0.7
arbeitslos	negative	-0.7
Arbeitsniederlegung	negative	-0.7
Arbeitsplatzabbau	negative	-0.7
Arbeitsplatzsicherung	positive	0.7
Arbeitsplatzverlust	negative	-1
arbeitsscheu	negative	-0.7
Arbeitssicherheit	positive	0.7
Arbeitssucht	negative	-1
Arbeitstauglichkeit	positive	1
Arbeitsunfähigkeit	negative	-0.7
Arbeitsunfähigkeit	negative	-1
arbeitsunfähig	negative	-1
Arbeitsuntauglichkeit	negative	-1
arbeitsunwillig	negative	-0.7
Arbeitsverweigerung	negative	-0.7
Arbeitswille	positive	0.7
arbeitswillig	positive	0.7
ärgerlich	negative	-1
Ärger	negative	-1
ärgern	negative	-1
Arglistigkeit	negative	-1
arglistig	negative	-1
Arglist	negative	-1
arglos	negative	-0.7
arg	negative	-1
Arg	negative	-1
argwöhnen	negative	-1
argwöhnisch	negative	-1
Argwohn	negative	-1
aristokratisch	positive	0.7
Armbruch	negative	-1
ärmlich	negative	-0.7
arm	negative	-0.7
arm	negative	-1
Armseligkeit	negative	-0.7
armselig	negative	-1
Armverletzung	negative	-0.7
Arretierung	negative	-0.7
arrogant	negative	-0.7
Arterienverkalkung	negative	-1
Arteriosklerose	negative	-1
Arthritis	negative	-1
artig	positive	1
Artilleriefeuer	negative	-1
Artrose	negative	-1
Asbestsanierung	positive	0.7
Asbestsanierung	positive	1
asketisch	positive	0.7
asozial	negative	-1
Ästhetik	positive	1
ästhetisch	positive	1
Asthma	negative	-1
ästimieren	positive	1
astrein	positive	1
astronomisch	negative	-0.7
Asylantenfeindlichkeit	negative	-1
Asylantenfreundlichkeit	positive	1
atemberaubend	positive	1
Atembeschwerde	negative	-1
Atemnot	negative	-1
atemraubend	positive	1
atomenergiefrei	positive	0.7
Atomexplosion	negative	-1
Atomhandel	negative	-0.7
Atomisierung	negative	-1
Atomkrieg	negative	-1
Atomschmuggel	negative	-0.7
atomwaffenfrei	positive	1
Attacke	negative	-0.7
Attacke	negative	-1
attackieren	negative	-1
Attentat	negative	-0.7
attestieren	positive	0.7
attrahieren	positive	0.7
Attraktion	positive	0.7
Attraktivität	positive	1
attraktiv	positive	1
ätzend	negative	-1
Aufarbeitung	positive	0.7
aufbauschen	negative	-1
Aufbaustudium	positive	1
aufblähen	negative	-1
aufblühen	positive	0.7
Aufbruch	negative	-0.7
Aufbruchstimmung	positive	1
aufdrängen	negative	-0.7
Aufdringlichkeit	negative	-1
aufdringlich	negative	-0.7
auffressen	negative	-0.7
Auffrischung	positive	0.7
aufgeben	negative	-0.7
aufgeblasen	negative	-0.7
aufgebracht	negative	-0.7
aufgedreht	negative	-0.7
aufgedunsen	negative	-0.7
aufgekratzt	negative	-0.7
aufgelöst	negative	-1
aufgeschlossen	positive	1
aufgetrieben	negative	-0.7
aufgeweckt	positive	1
aufheitern	positive	1
Aufheiterung	positive	1
aufhetzend	negative	-1
aufhetzen	negative	-1
aufklären	positive	0.7
aufklärerisch	positive	0.7
Aufklärungskampagne	positive	0.7
auflachen	positive	1
aufmerksam	positive	0.7
aufmerksam	positive	1
aufmuntern	positive	1
Aufmunterung	positive	1
Aufmüpfigkeit	negative	-1
aufmüpfig	negative	-0.7
aufnötigen	negative	-0.7
aufopferungsvoll	positive	1
aufpeitschen	negative	-1
aufputschen	negative	-1
Aufrechterhaltung	positive	0.7
aufrecht	positive	1
aufregen	negative	-1
aufreiben	negative	-0.7
Aufrichtigkeit	positive	1
aufrichtig	positive	1
aufrührerisch	negative	-1
Aufruhr	negative	-0.7
Aufrüstung	negative	-1
Aufsässigkeit	negative	-1
aufsässig	negative	-0.7
Aufschwung	positive	0.7
aufsehenerregend	positive	0.7
Aufsehen_erregend	positive	0.7
aufstacheln	negative	-1
aufständisch	negative	-0.7
Aufstand	negative	-0.7
aufsteigen	positive	0.7
Aufstieg	positive	0.7
Auftrieb	positive	0.7
aufwändig	negative	-1
Aufwärtsentwicklung	positive	0.7
Aufwärtstrend	positive	0.7
Aufwartung	positive	0.7
aufwendig	negative	-1
Aufwerten	positive	0.7
Aufwertung	positive	0.7
aufwiegelnd	negative	-1
Aufwiegelung	negative	-0.7
aufwieglerisch	negative	-1
aufwühlen	negative	-1
auf_Zack	positive	1
aufziehen	negative	-1
aufzwingen	negative	-1
Augendienerei	positive	1
Augenerkrankung	negative	-1
Augenkrankheit	negative	-1
Augenschmaus	positive	0.7
Augenweide	positive	0.7
Augenwischerei	negative	-0.7
Augenwischerei	negative	-1
Aura	positive	1
ausbaden	negative	-0.7
ausbedingen	negative	-0.7
Ausbeutung	negative	-1
Ausbildungsförderung	positive	0.7
ausbluten	negative	-0.7
Ausbrechen	negative	-1
ausbrennen	negative	-0.7
Ausbruch	negative	-1
ausbuhen	negative	-1
Ausdauer	positive	0.7
ausdrucksstark	positive	1
ausdrucksvoll	positive	1
auseinanderdriften	negative	-0.7
auseinander_driften	negative	-1
auseinander_leben	negative	-1
auseinanderleben	negative	-1
auserkoren	positive	1
auserlesen	positive	1
ausersehen	positive	1
auserwählt	positive	1
ausfallend	negative	-1
Ausfall	negative	-1
ausflippen	negative	-1
Ausführlichkeit	positive	0.7
Ausführlichsein	positive	0.7
Ausfuhrverbot	negative	-0.7
Ausfuhrverbot	negative	-1
Ausgebranntheit	negative	-1
ausgebrannt	negative	-1
ausgebufft	negative	-1
ausgeflippt	negative	-0.7
Ausgeglichenheit	positive	0.7
ausgeglichen	positive	0.7
ausgehungert	negative	-1
ausgekocht	negative	-1
Ausgelassenheit	negative	-1
ausgelassen	positive	1
ausgelaugt	negative	-1
ausgeliefert	negative	-0.7
ausgemergelt	negative	-0.7
ausgepowert	negative	-1
ausgepumpt	negative	-1
ausgereift	positive	1
ausgeruht	positive	0.7
ausgesucht	positive	1
ausgewogen	positive	1
ausgezeichnet	positive	1
ausgrenzend	negative	-1
ausgrenzen	negative	-1
aushalten	negative	-0.7
aushalten	positive	0.7
ausharren	positive	0.7
ausheulen	negative	-1
aushöhlen	negative	-0.7
auskommen	positive	0.7
auskotzen	negative	-0.7
auskugeln	negative	-0.7
auslachen	negative	-1
Ausländerfeindlichkeit	negative	-1
ausländerfeindlich	negative	-1
Ausländerfreundlichkeit	positive	1
ausländerfreundlich	negative	-1
Ausländerhass	negative	-1
Ausländerhaß	negative	-1
auslaugen	negative	-0.7
auslöffeln	negative	-0.7
Auslöschung	negative	-1
ausmachen	positive	0.7
ausmustern	negative	-0.7
ausmustern	negative	-1
Ausnahmezustand	negative	-0.7
Ausnutzen	negative	-1
Ausnutzung	negative	-1
auspfeifen	negative	-1
auspowern	negative	-0.7
ausrasten	negative	-1
ausreichend	positive	0.7
ausrenken	negative	-0.7
Ausrotten	negative	-1
Ausrottung	negative	-1
ausruhen	positive	0.7
Aussatz	negative	-1
ausschelten	negative	-1
ausschimpfen	negative	-1
ausschlafen	positive	0.7
Ausschlag	negative	-0.7
ausschließen	negative	-0.7
Ausschmückung	positive	0.7
Ausschreitung	negative	-0.7
ausschweifend	negative	-1
Außergewöhnlichkeit	positive	1
außergewöhnlich	positive	1
außerordentlich	positive	1
Aussichtslosigkeit	negative	-1
aussichtslos	negative	-0.7
aussichtsreich	positive	1
aussitzen	positive	1
aussöhnen	positive	0.7
ausspannen	positive	0.7
aussperren	negative	-0.7
ausspucken	negative	-0.7
Ausstand	negative	-0.7
ausstoßen	negative	-0.7
Ausstrahlung	positive	1
Ausstrahlungskraft	positive	0.7
austricksen	negative	-0.7
Ausweglosigkeit	negative	-1
ausweglos	negative	-1
ausweinen	negative	-1
ausweisen	positive	0.7
Ausweisung	negative	-1
auszanken	negative	-1
auszehren	negative	-0.7
auszeichnen	positive	1
Autarkie	positive	0.7
autark	positive	0.7
authentisch	positive	1
authentisieren	positive	0.7
Authentizität	positive	0.7
Autismus	negative	-1
autistische_Störung	negative	-1
Autonomie	positive	0.7
autonom	positive	0.7
autorisieren	positive	0.7
autoritär	negative	-1
Avance	positive	0.7
avancieren	positive	0.7
Aversion	negative	-1
Badekur	positive	0.7
bagatellisieren	negative	-1
Bahnreform	positive	1
Balkankrieg	negative	-1
Ballerei	negative	-0.7
Bammel	negative	-1
Bandenkrieg	negative	-1
Bänderriss	negative	-0.7
Bänderriß	negative	-0.7
bändigen	positive	1
Bandscheibenvorfall	negative	-1
Bange_machen	negative	-1
bange	negative	-0.7
bangen	negative	-1
bang	negative	-0.7
bankrott	negative	-0.7
Banküberfall	negative	-0.7
bannen	positive	1
Barbarei	negative	-1
barbarisch	negative	-1
Bärendienst	positive	0.7
Barmherzigkeit	positive	1
barmherzig	positive	1
barsch	negative	-1
basisdemokratisch	positive	0.7
Bauchfellentzündung	negative	-1
Bauchfett	negative	-1
Bauchschmerz	negative	-1
Bauchschuss	negative	-1
Bauchschuß	negative	-1
Bauchspeck	negative	-1
Bauchweh	negative	-1
beängstigend	negative	-1
beanstanden	negative	-1
bedächtig	positive	0.7
bedacht	positive	0.7
bedachtsam	positive	0.7
bedanken	positive	0.7
Bedarf	positive	0.7
bedauerlich	negative	-1
bedauern	negative	-1
Bedauern	negative	-1
bedauernswert	negative	-1
bedeckt	negative	-0.7
Bedenklichkeit	negative	-0.7
bedenklich	negative	-1
bedeutungslos	negative	-1
Bedeutungsverlust	negative	-1
Bedienungsfeindlichkeit	negative	-0.7
Bedienungsfreundlichkeit	positive	0.7
bedingt	negative	-0.7
bedrängen	negative	-0.7
bedrängen	negative	-1
bedrohen	negative	-1
Bedrohlichkeit	negative	-1
bedrohlich	negative	-1
Bedrohung	negative	-1
bedröppelt	negative	-1
bedrückend	negative	-1
bedrückt	negative	-1
bedürfnislos	positive	0.7
Bedürfnis	positive	0.7
Bedürftigkeit	negative	-1
bedürftig	negative	-0.7
beehren	positive	1
beeiden	positive	1
beeidigen	positive	1
beeindruckend	positive	1
beeindrucken	positive	1
beeinflussbar	negative	-0.7
beeinflußbar	negative	-0.7
beeinträchtigt	negative	-1
Beeinträchtigung	negative	-0.7
befähigt	positive	1
befallen	negative	-1
Befangenheit	negative	-1
befangen	negative	-0.7
Beflissenheit	positive	1
beflissen	negative	-0.7
befördern	positive	0.7
Beförderung	positive	0.7
befreit	positive	1
Befreiung	positive	0.7
Befreiung	positive	1
Befreiungskampf	negative	-0.7
Befreiungskrieg	negative	-1
Befremden	negative	-0.7
befremden	negative	-1
befremdlich	negative	-1
Befremdung	negative	-0.7
befrieden	positive	1
befriedigend	positive	1
befriedigen	positive	0.7
Befriedigung	positive	1
Befriedung	positive	0.7
befugt	positive	1
befürchten	negative	-1
Befürchtung	negative	-1
befürworten	positive	0.7
begabt	positive	1
Begabung	positive	1
begehen	negative	-1
begehrenswert	positive	1
begehrlich	negative	-1
begehrt	positive	0.7
begeisternd	positive	1
begeistern	positive	1
begeistert	positive	1
Begeisterung	positive	1
Begeisterungsfähigkeit	positive	1
begeisterungsfähig	positive	1
Begierde	negative	-1
begierig	negative	-1
beglücken	positive	1
beglückwünschen	positive	1
begnadet	positive	1
begnügen	positive	1
begossen	negative	-0.7
begrenzt	negative	-0.7
begriffsstutzig	negative	-1
begriffstutzig	negative	-1
begründet	positive	1
begrüßen	positive	0.7
begrüßenswert	positive	1
Begünstigung	negative	-0.7
begütigen	positive	1
Behagen	positive	1
Behaglichkeit	positive	0.7
behaglich	positive	1
behämmert	negative	-1
beharren	negative	-0.7
Beharrlichkeit	positive	0.7
behend	positive	0.7
beherrschen	positive	0.7
beherrscht	positive	0.7
beherzt	positive	1
behexen	negative	-1
behilflich	positive	1
behindertengerecht	positive	1
behindert	negative	-0.7
Behinderung	negative	-1
behumpsen	negative	-0.7
behumsen	negative	-0.7
behütend	positive	1
behutsam	positive	0.7
Beibehalten	positive	0.7
Beibehaltung	positive	0.7
beichten	positive	0.7
Beifallsruf	positive	0.7
Beihilfe	negative	-0.7
Beilegung	positive	0.7
Beileid	positive	1
Beinbruch	negative	-1
beinhart	negative	-0.7
Beinschmerz	negative	-1
Beinschuss	negative	-1
Beinschuß	negative	-1
Beinverletzung	negative	-0.7
beispielhaft	positive	0.7
beispielhaft	positive	1
beißen	negative	-0.7
Beitragsanhebung	positive	0.7
Beitragserhöhung	positive	0.7
bejahen	positive	1
bejammern	negative	-1
bejubeln	positive	1
bekehren	positive	0.7
bekennen	positive	0.7
Bekenntnis	positive	0.7
bekifft	negative	-0.7
beklagen	negative	-1
beklatschen	positive	1
beklemmend	negative	-1
Beklemmung	negative	-1
Beklommenheit	negative	-1
beklommen	negative	-0.7
bekloppt	negative	-1
beknackt	negative	-1
bekräftigen	positive	0.7
Bekümmernis	negative	-1
bekümmert	negative	-1
belächeln	negative	-1
Belagerung	negative	-0.7
belämmert	negative	-1
belangen	negative	-1
belanglos	negative	-1
Belastbarkeit	positive	0.7
belastbar	positive	0.7
belastend	negative	-1
belasten	negative	-1
belastet	negative	-0.7
belastet	negative	-1
belästigen	negative	-1
belebend	positive	0.7
beleben	positive	0.7
belebt	positive	0.7
Belehrung	negative	-1
beleibt	negative	-0.7
beleidigend	negative	-1
beleidigen	negative	-1
beleidigt	negative	-1
Beleidigung	negative	-1
belesen	positive	1
beleumundet	positive	1
Beliebigkeit	negative	-0.7
Beliebigkeit	positive	1
Beliebtheit	positive	1
beliebt	positive	0.7
belobigen	positive	1
belohnen	positive	1
belügen	negative	-1
belustigen	positive	1
bemängeln	negative	-1
bemänteln	negative	-1
bemerkenswert	positive	1
bemitleiden	negative	-1
bemühen	negative	-1
benachteiligen	negative	-0.7
Benefizkonzert	positive	0.7
beneiden	negative	-1
Benutzerfeindlichkeit	negative	-0.7
Benutzerfreundlichkeit	positive	0.7
Benutzungsfeindlichkeit	negative	-0.7
Benutzungsfreundlichkeit	positive	0.7
benzen	negative	-0.7
Beobachtungsgabe	positive	0.7
Beobachtungsgabe	positive	1
Bequemlichkeit	negative	-0.7
Bequemlichkeit	positive	0.7
bequem	positive	0.7
berappeln	positive	1
berauschend	positive	1
berauscht	negative	-0.7
berechenbar	positive	0.7
berechnend	negative	-0.7
berechtigen	positive	0.7
berechtigt	positive	1
beredsam	positive	1
beredt	positive	1
Bereicherung	positive	0.7
bereinigen	positive	0.7
bereitwillig	positive	0.7
bereuen	negative	-1
Bergarbeiterstreik	negative	-0.7
Bergung	positive	0.7
Bergung	positive	1
berichtigen	positive	0.7
berserkern	negative	-1
berüchtigt	negative	-1
Berufsausbildung	positive	1
Berufsbildung	positive	1
Berufserkrankung	negative	-1
Berufsfreiheit	positive	0.7
Berufskrankheit	negative	-1
Berufsunfähigkeit	negative	-0.7
beruhigen	positive	1
beruhigt	positive	1
Beruhigung	positive	0.7
berühmt	positive	1
berühren	positive	1
Berührungsangst	negative	-1
besänftigen	positive	1
Besänftigung	positive	0.7
Beschädigung	negative	-0.7
Beschaffungskriminalität	negative	-0.7
Beschäftigungsabbau	negative	-0.7
Beschäftigungssicherung	positive	0.7
Beschäftigungstherapie	positive	0.7
beschämend	negative	-1
beschämt	negative	-1
Beschämung	negative	-1
Beschaulichkeit	positive	0.7
Beschaulichkeit	positive	1
bescheiden	negative	-1
bescheiden	positive	0.7
bescheiden	positive	1
bescheinigen	positive	0.7
bescheißen	negative	-1
bescheuert	negative	-1
Beschießung	negative	-1
beschimpfen	negative	-1
beschissen	negative	-1
Beschiss	negative	-0.7
Beschiß	negative	-0.7
Beschiss	negative	-1
Beschiß	negative	-1
beschlagen	positive	0.7
beschlussfähig	positive	1
beschlußfähig	positive	1
beschönigen	negative	-1
beschränkt	negative	-1
beschuldigen	negative	-1
Beschuss	negative	-1
Beschuß	negative	-1
Beschwerde	negative	-0.7
beschweren	negative	-1
beschwichtigen	positive	1
Beschwichtigung	positive	0.7
beschwingt	positive	0.7
beschwipst	negative	-1
beschworen	positive	0.7
beschwören	positive	1
beseelt	positive	1
Beseitigung	negative	-0.7
beseligen	positive	1
Besessenheit	negative	-1
besessen	negative	-0.7
besessen	negative	-1
Besetzung	negative	-0.7
beseufzen	negative	-1
besinnlich	positive	0.7
besinnungslos	negative	-1
besitzlos	negative	-0.7
besoffen	negative	-0.7
Besondere	positive	1
Besonderheit	positive	1
besonnen	positive	1
besorgniserregend	negative	-1
Besorgnis	negative	-1
besorgt	negative	-1
bespucken	negative	-1
bessern	positive	0.7
besser_stellen	positive	0.7
Besserung	positive	0.7
besserwisserisch	negative	-1
Beständigkeit	positive	1
Bestandsoptimierung	positive	0.7
Bestandssicherung	positive	0.7
bestärken	positive	0.7
bestätigen	positive	0.7
bestechend	positive	1
bestechen	negative	-1
Bestechlichkeit	negative	-1
bestechlich	negative	-1
Bestechung	negative	-0.7
Bestechung	negative	-1
Bestform	positive	0.7
bestialisch	negative	-1
bestimmt	negative	-0.7
bestmöglich	positive	1
bestrafen	negative	-1
Bestrafung	negative	-1
bestreiten	negative	-0.7
bestürzen	negative	-1
Bestürzung	negative	-0.7
beten	positive	1
beteuern	positive	1
betören	positive	1
betrauern	negative	-1
betreten	negative	-0.7
Betreuung	negative	-1
Betriebsamkeit	positive	0.7
betriebsam	positive	0.7
Betriebserlaubnis	positive	1
Betriebsgenehmigung	positive	1
Betriebsspionage	negative	-0.7
Betroffenheit	negative	-0.7
betroffen	negative	-0.7
betrüben	negative	-1
betrübt	negative	-1
betrügen	negative	-1
Betrügerei	negative	-0.7
Betrügerei	negative	-1
betrügerisch	negative	-1
Betrug	negative	-0.7
Betrug	negative	-1
Betrugsfall	negative	-0.7
Betrugsfall	negative	-1
betrunken	negative	-1
betteln	negative	-0.7
bettlägerig	negative	-1
betucht	positive	0.7
Betulichkeit	positive	0.7
betuppen	negative	-0.7
Beugehaft	negative	-1
Beule	negative	-0.7
beunruhigend	negative	-1
beunruhigen	negative	-1
beunruhigt	negative	-1
Beunruhigung	negative	-1
beurlauben	negative	-0.7
Beute	negative	-1
bevormunden	negative	-1
Bevormundung	negative	-0.7
bevorrechtigen	positive	0.7
bevorschussen	positive	0.7
bevorzugen	positive	0.7
bevorzugen	positive	1
bewaffneter_Kampf	negative	-0.7
bewahrheiten	positive	0.7
bewährt	positive	1
Bewährung	negative	-1
Bewahrung	positive	0.7
Bewährungsstrafe	negative	-1
bewandert	positive	0.7
bewegend	positive	0.7
bewegen	positive	0.7
beweglich	positive	1
bewegt	positive	0.7
Bewegung	positive	0.7
Bewegungsfreiheit	positive	0.7
Bewegungsfreiraum	positive	0.7
Bewegungsspielraum	positive	0.7
Bewegungstherapie	positive	0.7
beweinen	negative	-1
beweisen	positive	1
Beweiskraft	positive	0.7
Beweisnot	negative	-1
Beweissicherung	positive	0.7
bewilligen	positive	0.7
Bewilligung	positive	0.7
Bewilligung	positive	1
bewirken	positive	0.7
bewohnbar	positive	0.7
bewundern	positive	1
bewundernswert	positive	1
bewundert	positive	1
Bewusstlosigkeit	negative	-1
Bewußtlosigkeit	negative	-1
bewusstlos	negative	-0.7
bewußtlos	negative	-0.7
bewusstlos	negative	-1
bewußtlos	negative	-1
Bewusstseinsstörung	negative	-1
Bewußtseinsstörung	negative	-1
bezahlen	negative	-1
bezähmen	positive	1
bezaubernd	positive	1
bezaubern	positive	1
bezeigen	positive	1
bezichtigen	negative	-1
Beziehungslosigkeit	negative	-0.7
beziehungslos	negative	-0.7
Bezogenheit	positive	0.7
bezückend	positive	1
bezuschussen	positive	0.7
bezweifeln	negative	-1
bibbern	negative	-1
Bienenstich	negative	-0.7
bigott	negative	-1
Bilanzfälschung	negative	-0.7
Bilanzfälschung	negative	-1
Bilanzverlust	negative	-1
Bildersturm	negative	-1
bildhübsch	positive	1
bildungsfern	negative	-0.7
Bildungsreform	positive	1
billigen	positive	0.7
billigen	positive	1
billig	positive	1
Bindegewebsgeschwulst	negative	-1
Bioterrorismus	negative	-0.7
Bioterror	negative	-0.7
Bissigkeit	negative	-1
bissig	negative	-1
Biss	negative	-0.7
Biß	negative	-0.7
Biss	positive	1
Biß	positive	1
Bisswunde	negative	-0.7
Bißwunde	negative	-0.7
bitten	positive	1
bitterböse	negative	-1
Bitterkeit	negative	-1
bitter	negative	-0.7
bitter	negative	-1
bizarr	negative	-1
Black-out	negative	-1
Blackout	negative	-1
Blähungen	negative	-0.7
blamieren	negative	-1
blank	negative	-0.7
Blasenentzündung	negative	-1
Blasenstein	negative	-0.7
blasiert	negative	-0.7
Blasphemie	negative	-0.7
blasphemieren	negative	-1
blässeln	negative	-0.7
Blattern	negative	-1
blauäugig	negative	-0.7
bläuen	negative	-0.7
blaumachen	negative	-0.7
blau	negative	-0.7
Bleiben	positive	0.7
blendend	positive	0.7
blenden	negative	-1
Blendwerk	negative	-0.7
Blendwerk	negative	-1
blessieren	negative	-1
blessiert	negative	-1
Blessur	negative	-0.7
bleuen	negative	-0.7
Blickfang	positive	0.7
Blinddarmentzündung	negative	-1
Blindheit	negative	-1
blind	negative	-1
blind_werden	negative	-1
Blitzkrieg	negative	-1
blocken	negative	-0.7
blockieren	negative	-0.7
blöd	negative	-1
bloßstellen	negative	-1
Bloßstellung	negative	-1
bluffen	negative	-0.7
Bluff	negative	-0.7
Bluff	negative	-1
blühend	positive	0.7
Blumenpracht	positive	0.7
blutarm	negative	-0.7
blutarm	negative	-1
Blutarmut	negative	-1
Blutbad	negative	-0.7
Blutbad	negative	-1
blutend	negative	-1
Bluthochdruck	negative	-1
blutig	negative	-1
Blutkrebs	negative	-1
Blutrache	negative	-1
blutrünstig	negative	-1
Bluttat	negative	-0.7
Blutung	negative	-0.7
Blutvergießen	negative	-0.7
Blutvergießen	negative	-1
Blutvergiftung	negative	-1
Blutverlust	negative	-0.7
Bockigkeit	negative	-1
bockig	negative	-1
bodenlos	negative	-0.7
bodenlos	negative	-1
Bodenreform	positive	1
Bodensanierung	positive	0.7
Bodensanierung	positive	1
Bodenständigkeit	positive	0.7
bohrend	negative	-1
bölken	negative	-1
Bombardement	negative	-1
Bombardierung	negative	-1
bombastisch	positive	1
Bombenangriff	negative	-1
Bombenanschlag	negative	-0.7
Bombenanschlag	negative	-1
Bombenattentat	negative	-0.7
Bombenattentat	negative	-1
Bombendrohung	negative	-1
Bombenkrieg	negative	-1
bombensicher	positive	0.7
Bombenstimmung	positive	1
borniert	negative	-1
Börsenhoch	positive	0.7
Bösartigkeit	negative	-1
bösartig	negative	-1
böse	negative	-1
Boshaftigkeit	negative	-1
boshaft	negative	-1
Bosheit	negative	-1
bös	negative	-1
Böswilligkeit	negative	-1
böswillig	negative	-1
boykottieren	negative	-1
Boykott	negative	-0.7
Brachialgewalt	negative	-1
brachial	negative	-1
Brandanschlag	negative	-0.7
brandmarken	negative	-1
Brandrodung	negative	-1
Brandschatzung	negative	-0.7
Brandstiftung	negative	-0.7
Brandursache	negative	-0.7
Brauchbarkeit	positive	0.7
Bravo	positive	0.7
Bravoruf	positive	0.7
brav	positive	1
Breitseite	negative	-1
Bremsenstich	negative	-0.7
brennen	negative	-0.7
brillant	positive	1
Brillanz	positive	1
brillieren	positive	1
Bringschuld	negative	-0.7
Bronchitis	negative	-1
brotlos	negative	-0.7
Bruch	negative	-0.7
Bruch	negative	-1
Bruderkrieg	negative	-1
Brüderlichkeit	positive	1
brüllen	negative	-1
brummeln	negative	-0.7
brüskieren	negative	-1
brüsk	negative	-1
Brustkrebs	negative	-1
Brutalität	negative	-1
brutal	negative	-1
BSE	negative	-0.7
Bücherverbrennung	negative	-1
bucklig	negative	-1
Bulimie	negative	-1
bunt	positive	0.7
bürgen	positive	0.7
Bürgerfeindlichkeit	negative	-1
Bürgerfreundlichkeit	positive	1
Bürgerkrieg	negative	-1
Bürgernähe	positive	1
Bürgersinn	positive	1
Burnout	negative	-1
Burnout-Syndrom	negative	-1
büßen	negative	-1
Bußgeld	negative	-1
canceln	negative	-1
Chancengleichheit	positive	0.7
chancenlos	negative	-1
chancenreich	positive	1
Chaos	negative	-1
charakterfest	positive	1
Charakterlosigkeit	negative	-1
charakterlos	negative	-1
Charakterstärke	positive	1
Charisma	positive	1
charismatisch	positive	1
charmant	positive	1
Charme	positive	0.7
chauvinistisch	negative	-1
Chemotherapie	positive	0.7
Cholera	negative	-1
cholerischer_Anfall	negative	-1
cholerisch	negative	-1
Claustrophobie	negative	-1
clean	positive	0.7
clever	positive	1
Clinch	negative	-0.7
cool	positive	0.7
Coup	negative	-0.7
Courage	positive	1
Crash	negative	-1
dagegenhalten	negative	-1
dagegenstellen	negative	-0.7
dagegenstemmen	negative	-0.7
dahinleben	negative	-0.7
dahinsiechen	negative	-1
dämlich	negative	-1
Dämmung	negative	-0.7
dämonisch	negative	-1
dämonisieren	negative	-1
Dämonisierung	negative	-0.7
danebengegangen	negative	-1
daneben_liegen	negative	-0.7
danebenliegen	negative	-0.7
Dankbarkeit	positive	1
dankbar	positive	1
Dankempfindung	positive	1
Dankeschön	positive	0.7
Dankeswort	positive	0.7
Dankgefühl	positive	1
Dank	positive	0.7
Dank	positive	1
danksagen	positive	0.7
Dank_sagen	positive	0.7
darben	negative	-1
Darmkrebs	negative	-1
Darmpilz	negative	-0.7
Darmverschluss	negative	-1
Darmverschluß	negative	-1
Daseinsberechtigung	positive	0.7
Datensicherung	positive	0.7
Dauerkonflikt	negative	-0.7
Dauerkrise	negative	-1
dauern	negative	-1
Dauerstreit	negative	-0.7
davonjagen	negative	-1
dechiffrieren	positive	0.7
Defensive	positive	0.7
defensiv	negative	-1
Defizit	negative	-1
Deformation	negative	-1
deformiert	negative	-1
Deformierung	negative	-1
degagieren	negative	-1
degoutieren	negative	-1
degradieren	negative	-0.7
degradieren	negative	-1
Degradierung	negative	-1
Dehydration	negative	-1
dekadent	negative	-1
dekodieren	positive	0.7
Dekoration	positive	0.7
dekorativ	positive	0.7
dekorieren	positive	1
Dekor	positive	0.7
Delikt	negative	-0.7
delimitiert	negative	-1
delinquent	negative	-1
delirieren	negative	-1
Delirium	negative	-1
Demagogie	negative	-0.7
demagogisch	negative	-1
dementieren	negative	-0.7
dement	negative	-1
demokratisch	positive	0.7
Demontage	negative	-1
demoralisierend	negative	-1
demoralisieren	negative	-1
demotivieren	negative	-1
demotiviert	negative	-0.7
demütigend	negative	-1
demütigen	negative	-1
denkwürdig	negative	-1
Denkzettel	negative	-1
denunzieren	negative	-1
deplatziert	negative	-1
deplaziert	negative	-1
Deportation	negative	-0.7
Depression	negative	-1
Depressivität	negative	-1
depressiv	negative	-1
deprimierend	negative	-1
deprimieren	negative	-1
Deprimiertheit	negative	-1
deprimiert	negative	-1
derb	negative	-1
Dermatitis	negative	-1
desavouieren	negative	-1
Desertieren	negative	-0.7
Desertion	negative	-0.7
desillusionieren	negative	-1
desillusioniert	negative	-1
Desillusionierung	negative	-1
desinfizieren	positive	0.7
Desinteresse	negative	-1
desinteressiert	negative	-1
Desorganisation	negative	-1
Despektierlichkeit	negative	-1
despektierlich	negative	-1
Despotie	negative	-1
Destabilisieren	negative	-0.7
Destabilisieren	negative	-1
Destabilisierung	negative	-0.7
Destabilisierung	negative	-1
Destruktion	negative	-1
destruktiv	negative	-1
Detonation	negative	-1
deviant	negative	-1
devitalisieren	negative	-0.7
devot	negative	-1
Diabetes_mellitus	negative	-1
Diabetes	negative	-1
diabolisch	negative	-1
diabolisieren	negative	-1
Diamantene_Hochzeit	positive	0.7
Diamanthochzeit	positive	0.7
Diätenerhöhung	positive	0.7
Diättherapie	positive	0.7
dicht	negative	-0.7
Dickfelligkeit	negative	-0.7
dickfellig	positive	1
dickhäutig	positive	0.7
dick	negative	-0.7
Diebesgut	negative	-1
Diebstahl	negative	-1
dienlich	positive	1
diensteifrig	negative	-0.7
Diensttauglichkeit	positive	1
Dienstunfähigkeit	negative	-0.7
Dienstuntauglichkeit	negative	-1
diesig-kalt	negative	-0.7
diffamieren	negative	-1
Differenziertheit	positive	0.7
differenziert	positive	1
diktatorisch	negative	-1
Dilettantentum	negative	-1
dilettantisch	negative	-1
Dilettantismus	negative	-1
Diphterie	negative	-1
direkt	positive	0.7
direkt_sagen	positive	0.7
disharmonisch	negative	-0.7
diskeditieren	negative	-1
Diskretion	positive	0.7
diskret	positive	1
diskriminieren	negative	-1
disqualifizieren	negative	-1
dissozial	negative	-1
Distanzlosigkeit	negative	-1
distanzlos	negative	-0.7
distinguiert	positive	0.7
Disziplinlosigkeit	negative	-1
disziplinlos	negative	-1
Dividendenerhöhung	positive	0.7
Dolchstoß	negative	-0.7
doll	negative	-1
doll	positive	0.7
domestizieren	positive	1
dominant	negative	-1
Donnerwetter	negative	-1
doof	negative	-1
Doping	negative	-1
Doppelmord	negative	-0.7
Doppelspiel	negative	-0.7
Doppelspiel	negative	-1
Doppelzünigkeit	negative	-1
dorren	negative	-0.7
down	negative	-0.7
drakonisch	negative	-1
dramatisch	positive	0.7
drängeln	negative	-0.7
drängen	negative	-0.7
drangsalieren	negative	-1
drastisch	negative	-1
Drecksarbeit	negative	-1
Dreistigkeit	negative	-1
dreist	negative	-0.7
Dresche	negative	-0.7
Drogenabhängigkeit	negative	-1
Drogenbesitz	negative	-1
dröge	negative	-1
Drogeneinfluss	negative	-1
Drogeneinfluß	negative	-1
Drogeneinnahme	negative	-1
Drogenentziehungskur	positive	0.7
Drogenentzug	positive	0.7
drogenfrei	positive	0.7
Drogengenuss	negative	-1
Drogengenuß	negative	-1
Drogenhandel	negative	-0.7
Drogenkonsum	negative	-1
Drogenkriminalität	negative	-0.7
Drogenlieferung	negative	-0.7
Drogenmissbrauch	negative	-1
Drogenmißbrauch	negative	-1
Drogenproblem	negative	-1
Drogenrausch	negative	-1
Drogenschmuggel	negative	-0.7
Drogensucht	negative	-1
drohen	negative	-1
Drohung	negative	-1
drollig	positive	0.7
drollig	positive	1
drücken	negative	-1
Druckkopfschmerz	negative	-1
Druckkopfweh	negative	-1
drüsenkrank	negative	-1
Dschihad	negative	-1
dubios	negative	-1
Duckmäusertum	negative	-1
Duell	negative	-0.7
dufte	positive	1
dulden	negative	-0.7
dulden	positive	1
dull	negative	-1
dummdreist	negative	-0.7
dumm	negative	-1
Dumpfheit	negative	-1
Düngung	positive	0.7
dünkelhaft	negative	-0.7
dunkel	negative	-0.7
Dunkelziffer	negative	-0.7
Dünnhäutigkeit	negative	-0.7
dünnhäutig	negative	-1
düpieren	negative	-0.7
Durchblutungsstörung	negative	-1
durchdrehen	negative	-0.7
durcheinander_bringen	negative	-0.7
durcheinanderbringen	negative	-0.7
durcheinander_bringen	negative	-1
durcheinanderbringen	negative	-1
durcheinander	negative	-1
Durcheinander	negative	-1
durchfallen	negative	-0.7
Durchfall	negative	-1
durchgeknallt	negative	-0.7
durchhalten	positive	0.7
Durchhaltevermögen	positive	0.7
Durchhänger	negative	-1
durchkreuzen	negative	-0.7
durchleiden	negative	-1
durchmachen	negative	-0.7
Durchsetzungsfähigkeit	positive	1
durchsetzungsfähig	positive	1
Durchsetzungskraft	positive	0.7
Durchsetzungsvermögen	positive	1
Durchsichtigkeit	positive	0.7
durchstehen	positive	0.7
durchtrainiert	positive	0.7
Durchtriebenheit	negative	-1
durchtrieben	negative	-1
Dürftigkeit	negative	-0.7
dürftig	negative	-0.7
dürr	negative	-0.7
dursten	negative	-0.7
dürsten	negative	-0.7
durstig	positive	0.7
düster	negative	-1
Düsternis	negative	-1
dynamisch	positive	0.7
dynamisch	positive	1
Ebenmäßigkeit	positive	0.7
ebenmäßig	positive	0.7
Echtheit	positive	1
echt	positive	1
Edelmütigkeit	positive	1
edelmütig	positive	1
Edelmut	positive	1
edel	positive	0.7
edel	positive	1
Effektivität	positive	0.7
effektiv	positive	1
effizient	positive	1
Effizienzverbesserung	positive	0.7
Egoismus	negative	-1
egoistisch	negative	-1
Egozentrik	negative	-1
egozentrisch	negative	-1
Ehekrach	negative	-1
Eheschließung	positive	0.7
Ehestreit	negative	-1
ehrenamtlich	positive	1
ehrenhaft	positive	1
ehren	positive	1
Ehrenrettung	positive	0.7
Ehrenrettung	positive	1
ehrenvoll	positive	1
ehrenwert	positive	1
ehrerbietend	positive	1
ehrerbietig	positive	1
ehrfürchtig	positive	1
Ehrfurcht	positive	1
Ehrgefühl	positive	1
ehrgeizig	positive	0.7
Ehrgeiz	positive	0.7
Ehrlichkeit	positive	1
ehrlich	positive	1
Ehrlosigkeit	negative	-1
ehrlos	negative	-1
ehrwürdig	positive	1
Eierstockentzündung	negative	-1
Eifer	positive	1
Eifersüchtelei	negative	-1
eifersüchteln	negative	-1
eifersüchtig	negative	-1
Eifersucht	negative	-1
Eifersuchtsszene	negative	-1
eifrig	positive	0.7
eigenartig	negative	-1
Eigenbrödelei	negative	-0.7
Eigenbrötelei	negative	-0.7
eigenbrötlerisch	negative	-1
Eigenlob	positive	1
eigenmächtig	negative	-1
eigennützig	negative	-1
Eigenregie	positive	0.7
eigensinnig	negative	-1
Eigenständigkeit	positive	0.7
eigenständig	positive	0.7
eigentümlich	negative	-1
Eigentumsdelikt	negative	-0.7
eigenwillig	negative	-1
Eignung	positive	1
eilfertig	negative	-0.7
einbilden	negative	-0.7
Einbringung	negative	-0.7
Einbruch	negative	-0.7
eindämmen	negative	-0.7
eindladend	positive	0.7
eindrücklich	positive	1
eindrucksvoll	positive	1
Einerlei	negative	-1
einfach	positive	0.7
Einfall	negative	-0.7
einfallslos	negative	-0.7
einfallsreich	positive	1
einfältig	negative	-1
einflusslos	negative	-0.7
einflußlos	negative	-0.7
einflussreich	positive	0.7
einflußreich	positive	0.7
einförmig	negative	-1
einfügen	positive	0.7
einfühlsam	positive	1
Einfühlungsvermögen	positive	0.7
Einfuhrverbot	negative	-0.7
Einfuhrverbot	negative	-1
eingängig	positive	1
eingebildet	negative	-1
eingeladen	positive	0.7
eingeschnappt	negative	-1
eingeschränkt	negative	-0.7
eingeschüchtert	negative	-1
eingestehen	positive	0.7
eingeweiht	positive	0.7
einimpfen	negative	-0.7
Einklang	positive	0.7
einklemmen	negative	-0.7
Einkommen	positive	0.7
Einkommenserhöhung	positive	0.7
einladend	positive	0.7
einladen	positive	0.7
einlenken	positive	0.7
einlullen	negative	-1
Einmaligkeit	positive	0.7
Einmarsch	negative	-0.7
Einnahme	negative	-0.7
Einnahme	positive	0.7
einnehmend	positive	0.7
einnehmen	positive	1
einprägsam	positive	1
einräumen	positive	0.7
einreden	negative	-0.7
Einsamkeit	negative	-1
einsam	negative	-0.7
einsatzfähig	positive	1
Einsatztauglichkeit	positive	0.7
Einsatzuntauglichkeit	negative	-0.7
einschläfern	negative	-0.7
einschläfern	negative	-1
Einschlag	negative	-1
einschleimen	negative	-0.7
einschmeicheln	negative	-0.7
einschneidend	negative	-1
einschüchtern	negative	-0.7
einschüchtern	negative	-1
Einseitigkeit	negative	-0.7
einseitig	negative	-0.7
einsichtig	positive	0.7
einstecken	positive	1
einstehen	positive	0.7
Einstellung	positive	0.7
Eintönigkeit	negative	-1
eintönig	negative	-1
Eintreten	positive	0.7
Eintritt	positive	0.7
einvernehmlich	positive	1
einweihen	positive	0.7
einwenden	negative	-1
einwerfen	positive	0.7
einwickeln	negative	-0.7
Einzelhaft	negative	-1
Einzeltherapie	positive	0.7
Einzigartigkeit	positive	0.7
eisenhart	negative	-0.7
Eisenhochzeit	positive	0.7
Eiserne_Hochzeit	positive	0.7
eitel	negative	-1
Eiterbeule	negative	-1
Eitergeschwür	negative	-1
eiternd	negative	-1
eitrig	negative	-1
Eiweißallergie	negative	-1
ekelerregend	negative	-1
Ekel_erregend	negative	-1
Ekelgefühl	negative	-1
ekelhaft	negative	-1
Ekel	negative	-1
ekeln	negative	-1
eklig	negative	-1
Ekstase	positive	1
ekstatisch	positive	1
Elan	positive	1
elefantös	positive	0.7
Eleganz	positive	1
elend	negative	-1
Elend	negative	-1
Elfer	negative	-0.7
Elfer	negative	-1
Elfmeter	negative	-0.7
Elfmeter	negative	-1
Elfmeterschießen	negative	-0.7
Elfmeterschießen	negative	-1
Eliminieren	negative	-1
Eliminierung	negative	-1
elitär	negative	-0.7
Elitenförderung	positive	0.7
eloquent	positive	1
elternlos	negative	-0.7
Emanzipation	positive	0.7
emanzipieren	positive	0.7
Embargo	negative	-0.7
Embargo	negative	-1
emotionslos	negative	-0.7
Empathie	positive	0.7
empfänglich	positive	1
Empfängnisverhütung	positive	0.7
empfehlen	positive	0.7
empfehlen	positive	1
Empfehlen	positive	1
empfehlenswert	positive	1
Empfehlung	positive	1
empfindlich	negative	-1
empörend	negative	-1
empören	negative	-1
empört	negative	-1
Empörung	negative	-1
Emsigkeit	positive	1
emsig	positive	0.7
Endbearbeitung	positive	0.7
endgeil	positive	1
Endkampf	negative	-0.7
Endlichkeit	negative	-0.7
Endzeitstimmung	negative	-0.7
Endzeitstimmung	negative	-1
energiegeladen	positive	0.7
Energie	positive	1
Energieverlust	negative	-1
energisch	positive	0.7
Engagement	positive	1
engagiert	positive	0.7
Engpass	negative	-0.7
eng	positive	1
Engstirnigkeit	negative	-1
engstirnig	negative	-1
entartet	negative	-1
Entbehrung	negative	-0.7
Entbindung	positive	0.7
Entbindung	positive	1
entbrennen	positive	0.7
entfallen	negative	-0.7
Entfaltungsmöglichkeit	positive	0.7
entfernen	negative	-0.7
entflammen	positive	0.7
entflammt	positive	0.7
entfremden	negative	-1
entfremdet	negative	-0.7
Entfremdung	negative	-1
Entführung	negative	-0.7
entgegenhalten	negative	-1
entgegenkommend	positive	0.7
entgegenkommen	positive	0.7
entgegenstellen	negative	-0.7
entgeistern	negative	-1
entgeistert	negative	-1
Entgeisterung	negative	-1
Entgiftung	positive	0.7
entgleisen	negative	-1
Entgrenzung	positive	0.7
Entgrenzung	positive	1
enthaltsam	positive	0.7
entheben	negative	-0.7
entheiligen	negative	-1
enthüllen	positive	0.7
Enthusiasmus	positive	1
enthusiastisch	positive	1
entkräfigen	positive	1
entkräftet	negative	-1
entkriminalisieren	positive	1
Entkriminalisierung	positive	0.7
Entladung	negative	-1
entlassen	negative	-0.7
Entlassung	positive	0.7
entlasten	positive	0.7
entlasten	positive	1
entleert	negative	-1
entmannen	negative	-0.7
Entmilitarisierung	positive	0.7
Entmündigung	negative	-1
entmutigend	negative	-1
entmutigen	negative	-0.7
entmutigen	negative	-1
Entmutigung	negative	-1
enträtseln	positive	0.7
Entrücktheit	positive	1
entrückt	positive	0.7
entrüsten	negative	-1
entrüstet	negative	-1
Entrüstung	negative	-1
entsagend	positive	0.7
entsagungsvoll	positive	0.7
Entscheidungsfreiheit	positive	0.7
Entscheidungsgewalt	positive	0.7
Entscheidungsspielraum	positive	0.7
Entschlackung	positive	0.7
entschlüsseln	positive	0.7
entschuldigen	positive	1
Entschuldigung	positive	0.7
entschwinden	negative	-0.7
entseelt	negative	-1
entsetzen	negative	-1
Entsetzen	negative	-1
entsetzlich	negative	-1
entsetzt	negative	-1
Entsorgung	negative	-1
entspannend	positive	0.7
entspannen	positive	1
Entspanntheit	positive	0.7
entspannt	positive	0.7
Entspannungsbad	positive	0.7
entstellt	negative	-1
Entstellung	negative	-1
enttäuschend	negative	-1
enttäuschen	negative	-1
enttäuscht	negative	-1
Enttäuschung	negative	-1
Enttraumatisierungstherapie	positive	0.7
Entwaffnung	positive	0.7
entweihen	negative	-1
Entwicklungspotenzial	positive	0.7
entwirren	positive	0.7
entwürdigend	negative	-1
entwürdigen	negative	-1
entwurzelt	negative	-0.7
Entziehungserscheinungen	negative	-1
Entziehungskur	positive	0.7
entzückend	positive	1
entzücken	positive	1
Entzücken	positive	1
Entzug	positive	0.7
Entzugserscheinungen	negative	-1
entzünden	negative	-0.7
entzündet	negative	-1
Entzündung	negative	-1
Epidemie	negative	-1
Epilepsie	negative	-1
erbarmen	positive	0.7
erbarmen	positive	1
Erbarmen	positive	1
erbärmlich	negative	-1
erbarmungslos	negative	-0.7
Erbarmunslosigkeit	negative	-1
erbaulich	positive	0.7
erbeben	negative	-1
erbeten	positive	0.7
erbitten	positive	0.7
erbittern	negative	-1
erbittert	negative	-1
Erbitterung	negative	-1
erblinden	negative	-1
erbosen	negative	-1
erbost	negative	-1
Erbrechen	negative	-1
Erbsünde	negative	-0.7
erdichten	negative	-0.7
Erdölkrise	negative	-0.7
erdreisten	negative	-0.7
erdrückend	negative	-1
erdulden	negative	-0.7
erdulden	negative	-1
Erdverbundenheit	positive	0.7
ererbt	positive	1
erfinden	negative	-0.7
erfinderisch	positive	1
Erfindungsreichtum	positive	0.7
Erfolglosigkeit	negative	-1
erfolglos	negative	-1
Erfolg	positive	1
erfolgreich	positive	1
erfolgsgewöhnt	positive	1
erfolgsverwöhnt	positive	1
Erfolgszwang	negative	-0.7
erfolgversprechend	positive	1
Erfolg_versprechend	positive	1
erfrechen	negative	-1
erfreuen	positive	1
erfreulich	positive	1
erfrieren	negative	-1
erfrischend	positive	0.7
erfunden	negative	-1
ergebnislos	negative	-1
ergiebig	positive	1
Ergotherapie	positive	0.7
ergötzen	positive	1
ergreifend	positive	0.7
Ergreifung	negative	-0.7
Ergreifung	positive	0.7
Ergriffenheit	positive	1
ergriffen	positive	0.7
Erhabenheit	positive	1
erhaben	positive	1
erhaltenswert	positive	1
Erhalt	positive	0.7
Erhaltung	positive	0.7
Erhängung	negative	-0.7
erheitern	positive	1
Erheiterung	positive	1
erhöhen	positive	0.7
erhöht	positive	0.7
Erhöhung	positive	0.7
erholen	positive	0.7
erholen	positive	1
erholsam	positive	0.7
erholungsbedürftig	negative	-1
erkälten	negative	-1
erkältet	negative	-1
Erkältung	negative	-1
Erkältungsbad	positive	0.7
Erkältungskrankheit	negative	-1
erkoren	positive	1
erkranken	negative	-1
Erkranken	negative	-1
Erkrankung	negative	-1
erkühnen	negative	-1
erlahmen	negative	-0.7
erlauben	positive	1
Erlaubnis	positive	0.7
erlaucht	positive	1
erledigt	negative	-0.7
erleichtern	positive	0.7
erleichtert	positive	1
Erleichterung	positive	0.7
erleiden	negative	-0.7
erleiden	negative	-1
erleuchtet	positive	1
erlogen	negative	-1
erlöst	positive	1
Erlösung	positive	0.7
ermahnen	negative	-1
Ermahnung	negative	-1
ermatten	negative	-1
Ermattung	negative	-1
Ermessensspielraum	positive	0.7
Ermordung	negative	-0.7
ermüdend	negative	-1
ermüden	negative	-1
Ermüdung	negative	-1
ermüdungsfrei	positive	0.7
ermunternd	positive	0.7
ermuntern	positive	1
Ermunterung	positive	1
ermutigen	positive	1
Ermutigung	positive	1
Ernährungskrankheit	negative	-1
Ernährungstherapie	positive	0.7
ernennen	positive	0.7
Erneuerung	positive	0.7
erniedrigen	negative	-1
ernsthaft	positive	0.7
Ernst	negative	-1
ernüchtern	negative	-1
Ernüchterung	negative	-1
erobern	positive	1
Eroberung	negative	-0.7
Eroberungskrieg	negative	-1
Erotomanie	negative	-1
erpressen	negative	-1
Erpressung	negative	-0.7
erprobt	positive	1
erqickend	positive	1
erquicklich	positive	1
erregen	negative	-1
Erregung	negative	-1
Errettung	positive	0.7
Errettung	positive	1
ersaufen	negative	-1
Erschießung	negative	-0.7
erschlaffen	negative	-1
Erschlaffung	negative	-1
erschöpft	negative	-1
Erschöpfung	negative	-1
Erschöpfungssyndrom	negative	-1
Erschöpfungszustand	negative	-1
erschreckend	negative	-1
erschrecken	negative	-1
erschrocken	negative	-1
erschütternd	negative	-0.7
erschüttern	negative	-0.7
erschüttert	positive	0.7
Erschütterung	negative	-0.7
ersehnen	positive	0.7
Erstattungsanspruch	positive	0.7
erstaunen	positive	1
erstaunlich	positive	1
ersticken	negative	-1
erstklassig	positive	1
erstreben	positive	0.7
erstrebenswert	positive	1
Erstürmung	negative	-0.7
ertauben	negative	-1
ertragen	positive	0.7
ertragreich	positive	1
ertragsarm	negative	-1
ertragsfähig	positive	1
ertragssicher	positive	1
ertrinken	negative	-1
Eruption	negative	-1
erwärmen	positive	1
Erwartungsdruck	negative	-0.7
erwartungsvoll	positive	1
erwerbslos	negative	-0.7
Erwerbsunfähigkeit	negative	-0.7
erwünscht	positive	1
erziehungsberechtigt	positive	1
erzürnen	negative	-1
erzürnt	negative	-1
erzwingen	negative	-1
Eskalation	negative	-0.7
Eskapismus	negative	-1
Esprit	positive	1
Esssucht	negative	-1
Eßsucht	negative	-1
ethisch	positive	1
Etikettenschwindel	negative	-0.7
Etikettenschwindel	negative	-1
etlich	positive	0.7
Euphorie	positive	1
euphorisch	positive	1
euphorisieren	positive	1
Euthanasie	negative	-0.7
Exaktheit	positive	1
exaltieren	negative	-1
exaltiert	negative	-0.7
Exekution	negative	-0.7
exemplarisch	positive	0.7
Exhibitionismus	negative	-1
Existenzangst	negative	-1
Existenzberechtigung	positive	0.7
Existenzgründung	positive	0.7
Existenzrecht	positive	0.7
Existenzsicherung	positive	0.7
Exitenzkrise	negative	-1
exkommunizieren	negative	-0.7
exkulpieren	positive	1
Exkurs	negative	-0.7
Experimentierfreude	positive	1
explodieren	negative	-0.7
Explosion	negative	-1
Exportverbot	negative	-0.7
Exportverbot	negative	-1
expressiv	positive	1
Extravaganz	negative	-0.7
extremistisch	negative	-1
exzellent	positive	1
exzentrisch	negative	-0.7
exzeptionell	positive	1
exzessiv	negative	-1
fabelhaft	positive	1
fabulieren	negative	-0.7
facettenreich	positive	0.7
fachbezogen	positive	0.7
fachgerecht	positive	1
fachkompetent	positive	1
fachkundig	positive	1
fachlich	positive	0.7
fackeln	negative	-0.7
fade	negative	-1
fadenscheinig	negative	-1
Fadheit	negative	-1
Fähigkeit	positive	0.7
fähig	positive	1
Fahnenflucht	negative	-0.7
Fahrerflucht	negative	-0.7
Fahrerlaubnis	positive	1
Fahrgenuss	positive	1
Fahrgenuß	positive	1
Fahrlässigkeit	negative	-0.7
fahrlässig	negative	-1
fahrstuhlgerecht	positive	1
Fahrtüchtigkeit	positive	0.7
Fahrvergnügen	positive	1
Fahrwerkstuning	positive	0.7
Faible	positive	1
Fairness	positive	1
Fairneß	positive	1
fair	positive	1
fallbezogen	positive	0.7
Falschaussage	negative	-1
Fälschen	negative	-0.7
Fälschen	negative	-1
Falschheit	negative	-1
fälschlich	negative	-1
falsch	negative	-1
Fälschung	negative	-0.7
Fälschung	negative	-1
familienfeindlich	negative	-1
familienfreundlich	positive	1
familiengerecht	positive	1
Familienkrach	negative	-1
Familiensinn	positive	1
Familienstreit	negative	-1
fanatisch	negative	-1
fanatisieren	negative	-1
Fanatismus	negative	-1
fantasieren	negative	-0.7
fantasievoll	positive	1
fantastisch	positive	1
Farbenblindheit	negative	-1
faseln	negative	-1
Fassungslosigkeit	negative	-1
fassungslos	negative	-1
Fastenkur	positive	0.7
Faszination	positive	0.7
faszinierend	positive	0.7
faszinieren	positive	1
fasziniert	positive	1
fatal	negative	-1
Faulheit	negative	-0.7
faul	negative	-1
Fäulnisgeschmack	negative	-0.7
Fehde	negative	-1
Fehlbildung	negative	-1
fehleinschätzen	negative	-0.7
Fehlerfreiheit	positive	1
fehlerfrei	positive	0.7
fehlerfrei	positive	1
fehlerhaft	negative	-1
Fehlerlosigkeit	positive	1
fehlerlos	positive	0.7
fehlerlos	positive	1
Fehlernährung	negative	-1
Fehlerursache	negative	-0.7
fehlgeschlagen	negative	-1
Fehlhandlung	negative	-0.7
fehlinterpretieren	negative	-1
Fehlkalkulation	negative	-1
fehlleitend	negative	-1
Fehltritt	negative	-0.7
feierlich	positive	0.7
feierlich	positive	1
feiern	positive	0.7
feiern	positive	1
feige	negative	-0.7
feige	negative	-1
Feigheit	negative	-1
Feindlichkeit	negative	-1
feindlich	negative	-1
feindschaftlich	negative	-1
Feindschaft	negative	-1
feindselig	negative	-1
feinfühlig	negative	-1
Feingefühl	positive	1
feingeistig	positive	1
fein_geschnitten	positive	0.7
feingeschnitten	positive	0.7
feingründig	positive	1
Feinnervigkeit	positive	1
feinnervig	negative	-1
fein	positive	0.7
fein	positive	1
feinsinnig	positive	1
feist	negative	-0.7
feixen	negative	-1
Feldverweis	negative	-1
felsenfest	positive	0.7
fernhalten	negative	-1
fertig_machen	negative	-1
fertigmachen	negative	-1
fertig	negative	-1
Fertigstellung	positive	0.7
fesselnd	positive	0.7
fesseln	negative	-1
Fesselung	negative	-0.7
Festigen	positive	1
Festigkeit	positive	1
Festigung	positive	1
festlegen	positive	0.7
festlich	positive	0.7
Festnahme	negative	-0.7
fest	negative	-0.7
fest	positive	0.7
fetischisieren	negative	-0.7
fetischistisch	negative	-1
fettig	negative	-0.7
fettleibig	negative	-0.7
fett	negative	-0.7
fett	positive	0.7
Fettsucht	negative	-1
Feuer	negative	-1
feuern	negative	-0.7
Feuer	positive	0.7
Feuerzauber	negative	-1
feurig	positive	0.7
fidel	positive	1
fieberfrei	positive	1
fieberhaft	negative	-1
Fieber	negative	-1
fies	negative	-1
fiktiv	negative	-1
filmbegeistert	positive	1
Filmgenuss	positive	1
Filmgenuß	positive	1
filminteressiert	positive	1
Finanzierungsprogramm	positive	0.7
Finanzreform	positive	1
Finesse	positive	1
Fingerbruch	negative	-1
fingerfertig	positive	1
Fingerspitzengefühl	positive	1
fingieren	negative	-0.7
Finte	negative	-0.7
Finte	negative	-1
Firmengründung	positive	0.7
Firmenspionage	negative	-0.7
Fitness	positive	1
Fitneß	positive	1
fit	positive	0.7
fixiert	negative	-0.7
Flatterhaftigkeit	negative	-1
flatterhaft	negative	-1
flatterig	negative	-1
flau	negative	-1
Flechte	negative	-0.7
flegelhaft	negative	-1
Fleischwunde	negative	-0.7
Fleißigkeit	positive	1
fleißig	positive	0.7
Fleiß	positive	1
flennen	negative	-1
flexibel	positive	1
Flexibilität	positive	0.7
flexiblisieren	positive	0.7
Flickwerk	negative	-1
flippig	negative	-0.7
Flitterwochen	positive	0.7
Flohstich	negative	-0.7
Flor	positive	0.7
fluchen	negative	-1
Flüchtigkeit	negative	-0.7
Flugerlaubnis	positive	0.7
Fluglärm	negative	-0.7
Flugsicherung	positive	0.7
Flugzeugentführung	negative	-0.7
flunkern	negative	-1
folgenreich	negative	-1
folgenschwer	negative	-1
folgerichtig	positive	1
folgsam	positive	0.7
Folter	negative	-0.7
Folterung	negative	-0.7
foppen	negative	-0.7
foppen	negative	-1
förderlich	positive	0.7
fördernd	positive	0.7
fördern	positive	0.7
Förderprogramm	positive	0.7
förderungswürdig	positive	1
Formgefühl	positive	1
förmlich	negative	-0.7
Formschönheit	positive	0.7
formschön	positive	1
formvollendet	positive	1
forsch	negative	-0.7
Fortbildung	positive	1
fortekeln	negative	-1
fortjagen	negative	-1
fortpflanzungsfähig	positive	0.7
fortschicken	negative	-0.7
Fortschreibung	positive	0.7
Fortschrittlichkeit	positive	0.7
Foulelfmeter	negative	-0.7
Foulelfmeter	negative	-1
Foul	negative	-1
Foulspiel	negative	-1
Fragilität	negative	-0.7
fraglich	negative	-0.7
Fragwürdigkeit	negative	-0.7
fragwürdig	negative	-0.7
Fraktur	negative	-1
frappierend	positive	1
frappieren	negative	-1
Frauenfeindlichkeit	negative	-1
frauenfeindlich	negative	-1
frauenfreundlich	positive	1
Frauenhass	negative	-1
Frauenhaß	negative	-1
Frauenrecht	positive	0.7
Frechheit	negative	-1
frech	negative	-1
freien	positive	0.7
Freigabe	positive	0.7
freigeben	positive	0.7
freigebig	positive	0.7
freigiebig	positive	0.7
freiheitlich	positive	0.7
Freiheit	positive	1
Freiheitseinzug	negative	-1
Freiheitskampf	negative	-0.7
Freiheitsstrafe	negative	-1
Freilassung	positive	0.7
freimütig	positive	1
Freimut	positive	1
frei	positive	0.7
Freiraum	positive	0.7
freisprechen	positive	1
Freistoß	negative	-1
Freitod	negative	-0.7
Freiwilligkeit	positive	0.7
freiwillig	positive	0.7
Freizeitarrest	negative	-1
Freizeitvergnügen	positive	1
Freizügigkeit	positive	0.7
Freizügigkeit	positive	1
fremdeln	negative	-1
Fremdenfeindlichkeit	negative	-1
fremdenfeindlich	negative	-1
Fremdenhass	negative	-1
Fremdenhaß	negative	-1
fremden	negative	-1
fremdgehen	negative	-0.7
Fremdherrschaft	negative	-0.7
fremdtun	negative	-1
frenetisch	positive	0.7
Freudentaumel	positive	1
Freude	positive	1
freudig	positive	1
freudlos	negative	-0.7
freudlos	negative	-1
freuen	positive	1
Freundlichkeit	positive	1
freundlich	positive	1
freundschaftlich	positive	1
Freundschaft	positive	1
Frevel	negative	-0.7
Frieden	positive	1
friedenserhaltend	positive	0.7
Friedensgespräch	positive	0.7
Friedensmission	positive	1
Friedenssicherung	positive	0.7
Friedensverhandlung	positive	0.7
Friede	positive	1
Friedfertigkeit	positive	1
friedfertig	positive	1
friedlich	positive	1
friedliebend	positive	1
friedlos	negative	-0.7
frieren	negative	-1
frigide	negative	-0.7
frigid	negative	-0.7
frivol	negative	-1
frohgemut	positive	1
froh_gestimmt	positive	1
frohgestimmt	positive	1
Fröhlichkeit	positive	1
fröhlich	positive	1
frohlocken	positive	1
froh	positive	1
Frohsinn	positive	1
Frömmigkeit	positive	1
fronen	negative	-0.7
Frontalangriff	negative	-1
frösteln	negative	-1
frotzeln	negative	-1
fruchtbar	positive	0.7
Fruchtlosigkeit	negative	-0.7
fruchtlos	negative	-0.7
Frühlingsgefühle	positive	1
frusten	negative	-1
Frust	negative	-1
Frustration	negative	-1
frustrieren	negative	-1
frustriert	negative	-1
fuchsig	negative	-1
fuchsteufelswild	negative	-1
fügen	positive	1
führerlos	negative	-0.7
Führungsanspruch	positive	0.7
Führungspersönlichkeit	positive	0.7
füllig	positive	0.7
fundiert	positive	1
fündig	positive	1
Funktionsfähigkeit	positive	0.7
Funktionstüchtigkeit	positive	0.7
fürbitten	positive	0.7
furchtbar	negative	-1
fürchten	negative	-1
fürchterlich	negative	-1
furchterregend	negative	-1
Furcht_erregend	negative	-1
Furchtlosigkeit	positive	1
furchtlos	negative	-0.7
Furcht	negative	-1
furchtsam	negative	-0.7
furios	positive	0.7
Fürsorge	positive	0.7
fürsorglich	positive	1
fürsprechen	positive	0.7
Fußbruch	negative	-1
Fußerkrankung	negative	-0.7
Fußkrankheit	negative	-0.7
Fußmassage	positive	0.7
Fußpilz	negative	-0.7
Fußverletzung	negative	-0.7
Gabe	positive	1
galant	positive	1
gallenkrank	negative	-1
Gallenstein	negative	-0.7
gammelig	negative	-1
Gammellook	negative	-0.7
Gammeloptik	negative	-0.7
Gammeloutfit	negative	-0.7
gammlig	negative	-1
gängeln	negative	-1
Gängelung	negative	-0.7
Ganztagsbetreuung	negative	-1
garantieren	positive	0.7
Garbe	negative	-1
Gardinenpredigt	negative	-1
Garstigkeit	negative	-1
Gasexplosion	negative	-1
Gastfeindlichkeit	negative	-1
Gastfreundlichkeit	positive	1
Gastfreundschaft	positive	1
Gaudi	positive	1
geachtet	positive	1
Gebärmutterkrebs	negative	-1
gebeutelt	negative	-0.7
Gebietsreform	positive	1
gebildet	positive	1
geboren	positive	1
Geborgenheit	positive	1
Gebrechen	negative	-1
gebrechlich	negative	-1
gebrochen	negative	-0.7
Gebührenerhöhung	positive	0.7
gebührenfrei	positive	0.7
gebührenlos	positive	0.7
Gebundenheit	negative	-0.7
geckenhaft	negative	-1
Gedächtnisschwund	negative	-1
gedankenlos	negative	-0.7
gedankenverloren	negative	-0.7
gedankenvoll	positive	1
gedeihen	positive	0.7
Gedeihen	positive	0.7
Gedeih	positive	0.7
gediegen	positive	0.7
Gedrücktheit	negative	-1
gedrückt	negative	-0.7
gedulden	positive	0.7
geduldig	positive	1
Geduld	positive	1
geehrt	positive	1
gefährden	negative	-1
gefährdet	negative	-1
Gefahrenpotential	negative	-0.7
Gefährlichkeit	negative	-1
gefährlich	negative	-1
gefahrlos	positive	0.7
Gefallen	positive	0.7
Gefälligkeit	positive	0.7
gefällig	positive	1
gefälscht	negative	-1
Gefangennahme	negative	-0.7
gefangen_nehmen	negative	-1
gefangennehmen	negative	-1
Gefangenschaft	negative	-1
Gefängnishaft	negative	-1
Gefängnisstrafe	negative	-1
gefasst	positive	0.7
gefaßt	positive	0.7
gefragt	positive	0.7
gefräßig	negative	-1
Gefühllosigkeit	negative	-1
gefühllos	negative	-0.7
gefühllos	negative	-1
gefühlsarm	negative	-1
Gefühlsarmut	negative	-1
Gefühlsduselei	negative	-1
Gefühlskälte	negative	-1
gefühlskalt	negative	-1
Gefühlsregung	positive	1
Gefühlstiefe	positive	1
gefühlvoll	positive	1
Gegeier	positive	0.7
Gegenangriff	negative	-1
Gegenoffensive	negative	-1
Gegenschlag	negative	-0.7
Gegenschlag	negative	-1
gegenstandslos	negative	-0.7
Gegnerschaft	negative	-1
Gehaltserhöhung	positive	0.7
gehaltvoll	positive	1
Gehässigkeit	negative	-1
gehässig	negative	-1
Gehbehinderung	negative	-1
geheim_halten	negative	-0.7
geheimhalten	negative	-0.7
geheimnisvoll	positive	0.7
gehemmt	negative	-0.7
Gehirnerschütterung	negative	-1
Gehirnschlag	negative	-1
Gehirnwäsche	negative	-0.7
gehoben	positive	0.7
gehuldigt	positive	1
geiern	negative	-0.7
Geiern	positive	0.7
Geilheit	negative	-1
geil	negative	-0.7
geil	positive	0.7
Geiselhaft	negative	-1
Geiselnahme	negative	-0.7
geißeln	negative	-1
geisterhaft	negative	-1
geistesabwesend	negative	-1
geistesgegenwärtig	positive	1
geistesgestört	negative	-1
geistesklar	positive	1
Geisteskrankheit	negative	-1
geisteskrank	negative	-1
Geistesverwandtschaft	positive	0.7
geistig_behindert	negative	-1
geistlos	negative	-0.7
geistreich	positive	1
geisttötend	negative	-1
geizig	negative	-0.7
Geiz	negative	-1
geknickt	negative	-0.7
gekränkt	negative	-1
gekünstelt	negative	-0.7
Gelächter	positive	0.7
gelackmeiert	negative	-1
geladen	negative	-1
geladen	positive	0.7
Gelähmtheit	negative	-1
gelähmt	negative	-1
gelangweilt	negative	-0.7
Gelassenheit	positive	0.7
gelassen	positive	0.7
Gelbfieber	negative	-1
Gelbsperre	negative	-1
Gelbsucht	negative	-1
Geldbuße	negative	-1
Geldeinnahme	positive	0.7
Geldgier	negative	-1
Geldstrafe	negative	-1
Geldwäsche	negative	-0.7
geleert	negative	-1
Gelehrsamkeit	positive	0.7
Gelehrtheit	positive	1
gelehrt	positive	1
Gelenkentzündung	negative	-1
Gelenkschmerz	negative	-1
geliebt	positive	1
gelingen	positive	1
gelitten	positive	0.7
geloben	positive	0.7
geloben	positive	1
gelobigen	positive	1
gelobt	positive	1
gelogen	negative	-1
Geltungssucht	negative	-1
gelungen	positive	1
Gemächlichkeit	positive	0.7
gemäßigt	positive	1
gemeingefährlich	negative	-1
Gemeinheit	negative	-1
gemein	negative	-1
Gemeinnützigkeit	positive	0.7
gemeinnützig	positive	1
Gemeinsamkeit	positive	0.7
Gemeinschaftsfähigkeit	positive	0.7
Gemeinschaftsgefühl	positive	1
Gemeinschaftsgeist	positive	1
gemeinschaftsschädigend	negative	-1
Gemeinschaftssinn	positive	1
Gemeinsinn	positive	1
Gemetzel	negative	-0.7
Gemetzel	negative	-1
gemocht	positive	1
Gemorde	negative	-0.7
Gemorde	negative	-1
Gemütlichkeit	positive	0.7
Gemütlichkeit	positive	1
gemütlich	positive	1
Gemütstiefe	positive	1
gemütsvoll	positive	1
Genauigkeit	positive	0.7
Genehmigung	positive	0.7
Genehmigung	positive	1
genehm	positive	1
Geneigtheit	positive	1
geneigt	positive	1
Generalität	positive	0.7
Generalstreik	negative	-0.7
generös	positive	0.7
Genervtheit	negative	-1
genervt	negative	-1
genesen	positive	1
Genesung	positive	0.7
genialisch	positive	1
Genialität	positive	1
genial	positive	1
Genickschuss	negative	-1
Genickschuß	negative	-1
Genickstarre	negative	-0.7
genieren	negative	-1
genießen	positive	1
Genozid	negative	-0.7
Genozid	negative	-1
genügend	positive	0.7
genug	positive	0.7
genügsam	positive	0.7
Genuss	positive	1
Genuß	positive	1
gepflegt	positive	1
geplagt	negative	-1
Geplänkel	negative	-0.7
gequält	negative	-1
gerade_stehen	negative	-1
Geradlinigkeit	positive	0.7
geradlinig	positive	1
Gerangel	negative	-0.7
geraten	positive	1
Geraufe	negative	-1
Geräuschkulisse	negative	-0.7
gerechtfertigt	positive	1
Gerechtigkeit	positive	1
Gerechtigkeitsgefühl	positive	1
Gerechtigkeitssinn	positive	1
gerecht	positive	1
Gereiztheit	negative	-1
gereizt	negative	-1
geringfügig	negative	-1
gering	negative	-0.7
geringschätzen	negative	-1
geringwertig	negative	-1
gerissen	negative	-0.7
germanisieren	negative	-1
Geruhsamkeit	positive	1
geruhsam	positive	1
gesättigt	positive	1
Geschäftigkeit	positive	0.7
geschäftig	positive	0.7
Geschäftssinn	positive	1
Geschäftstüchtigkeit	positive	0.7
geschäftstüchtig	positive	0.7
geschätzt	positive	1
gescheit	positive	1
geschenkt	positive	0.7
Geschichtlichkeit	positive	1
Geschichtslosigkeit	negative	-1
geschickt	positive	1
geschieden	negative	-0.7
Geschlechtserkrankung	negative	-1
Geschlechtskrankheit	negative	-1
Geschmacklosigkeit	negative	-1
geschmackvoll	positive	1
geschockt	negative	-1
geschult	positive	0.7
geschunden	negative	-1
Geschwätzigkeit	negative	-0.7
Geschwisterliebe	positive	1
Geschwulst	negative	-1
Geschwür	negative	-1
Geselligkeit	positive	0.7
gesellig	positive	1
gesellschaftsunfähig	negative	-1
Gesetzesreform	positive	1
gesetzestreu	positive	0.7
gesetzlos	negative	-0.7
gesetzt	positive	0.7
gesichtslos	negative	-0.7
gesinnt	positive	0.7
gesittet	positive	1
gespensterhaft	negative	-1
gespenstig	negative	-1
gespenstisch	negative	-1
gespielt	negative	-1
Gespött	negative	-1
Gesprächstherapie	positive	0.7
Gespür	positive	1
Gestalttherapie	positive	0.7
Gestaltungskraft	positive	0.7
geständig	positive	0.7
gestehen	positive	0.7
gestorben	negative	-1
gestört	negative	-1
gestreng	negative	-0.7
gestresst	negative	-1
gesucht	positive	1
gesunden	positive	1
gesundet	positive	1
Gesundheit	positive	1
gesundheitsabträglich	positive	1
gesundheitsdienlich	positive	1
gesundheitsförderlich	positive	1
Gesundheitspflege	positive	0.7
Gesundheitsreform	positive	1
Gesundheitsversorgung	positive	0.7
Gesundheitsvorsorge	positive	0.7
gesund	positive	1
Gesundung	positive	0.7
Getöse	negative	-0.7
getrauen	positive	0.7
getreu	positive	1
gettoisieren	negative	-1
geübt	positive	0.7
gewähren	positive	0.7
gewährleisten	positive	0.7
Gewähr_leisten	positive	0.7
Gewährung	positive	0.7
Gewährung	positive	1
Gewaltakt	negative	-1
Gewaltdelikt	negative	-0.7
gewaltfrei	positive	1
Gewaltherrschaft	negative	-1
Gewaltlosigkeit	positive	0.7
gewaltlos	positive	1
Gewalt	negative	-1
gewaltsam	negative	-1
Gewalttätigkeit	negative	-1
gewalttätig	negative	-1
Gewalttat	negative	-0.7
Gewaltverbrechen	negative	-0.7
gewandt	positive	0.7
Gewehrschuss	negative	-1
Gewehrschuß	negative	-1
Gewerbefreiheit	positive	0.7
Gewichtsproblem	negative	-1
gewieft	positive	1
gewinnbringend	positive	1
Gewinn_bringend	positive	1
gewinnend	positive	0.7
gewinnen	positive	1
Gewinnerseite	positive	0.7
Gewinn	positive	0.7
gewissenhaft	positive	1
gewissenlos	negative	-1
Gewissensbisse	negative	-1
Gewissheit	positive	1
Gewißheit	positive	1
gewitzt	positive	1
Gewogenheit	positive	1
gewogen	positive	1
gezähmt	positive	0.7
Gezänk	negative	-0.7
geziert	negative	-1
gezwungen	negative	-0.7
Gicht	negative	-1
gieren	negative	-0.7
gierig	negative	-1
Gier	negative	-1
giften	negative	-1
giftfrei	positive	1
Giftgasanschlag	negative	-0.7
Giftgasattentat	negative	-0.7
gigantisch	positive	1
Gigantomanie	negative	-1
Glamour	positive	0.7
glänzend	positive	0.7
glänzen	positive	1
Glanzlicht	positive	0.7
glanzlos	negative	-0.7
Glanz	positive	0.7
glanzvoll	positive	0.7
Glauben	positive	1
Glaubenskrieg	negative	-1
Glaube	positive	1
glaubhaft	positive	1
Gläubigkeit	positive	1
Glaubwürdigkeit	positive	0.7
glaubwürdig	positive	1
Gleichberechtigung	positive	0.7
Gleichgültigkeit	negative	-1
gleichgültig	negative	-0.7
Gleichheitsgrundsatz	positive	0.7
Gleichheitsprinzip	positive	0.7
Gleichheitssatz	positive	0.7
Gleichklang	positive	0.7
Gleichmut	positive	0.7
Gleichstellung	positive	0.7
Gliederschmerz	negative	-1
glimpflich	positive	1
Gloria	positive	0.7
glorifizieren	positive	1
glorreich	positive	1
Glücklichkeit	positive	1
glücklich	positive	1
glücklos	negative	-1
Glück	positive	1
glückreich	positive	1
Glückseligkeit	positive	1
Glücksgefühl	positive	1
glückstrahlend	positive	1
glühend	positive	0.7
Glut	positive	0.7
Gnadenhochzeit	positive	0.7
Gnadenlosigkeit	negative	-1
gnadenlos	negative	-0.7
Gnade	positive	0.7
gnädig	positive	0.7
gnomenhaft	negative	-1
göbeln	negative	-0.7
Goldene_Hochzeit	positive	0.7
Goldgräberstimmung	positive	1
Goldhochzeit	positive	0.7
goldig	positive	0.7
Goldschatz	positive	0.7
Golfkonflikt	negative	-0.7
Golfkrieg	negative	-1
gönnen	positive	1
gönnerhaft	positive	0.7
Gotteslästerung	negative	-0.7
göttliche_Gnade	positive	0.7
göttlich	positive	0.7
gottlos	negative	-1
Gottvertrauen	positive	1
goutieren	positive	0.7
Grabenkrieg	negative	-1
Gradlinigkeit	positive	0.7
gradlinig	positive	1
graduieren	positive	0.7
graduiert_werden	positive	0.7
grämen	negative	-1
Gram	negative	-1
grandios	positive	1
granteln	negative	-1
Grantigkeit	negative	-1
grantig	negative	-1
grässlich	negative	-1
gräßlich	negative	-1
gratulieren	positive	1
grauenerregend	negative	-1
Grauen_erregend	negative	-1
grauenhaft	negative	-1
grauen	negative	-0.7
Grauen	negative	-1
grauenvoll	negative	-1
grauer_Star	negative	-0.7
grau	negative	-0.7
Grausamkeit	negative	-1
grausam	negative	-1
grausen	negative	-1
Grausen	negative	-1
grausig	negative	-1
Graus	negative	-1
Grazie	positive	1
graziös	positive	1
greinen	negative	-1
grenzenlos	positive	0.7
Grenzüberschreitung	negative	-0.7
griesgrämig	negative	-1
Griesgram	negative	-1
griffig	positive	1
grimassieren	negative	-0.7
grimmig	negative	-1
grinsen	positive	1
Grippe	negative	-1
grob	negative	-0.7
grob	negative	-1
grobschlächtig	negative	-1
groggy	negative	-1
grölen	negative	-1
grollen	negative	-1
Groll	negative	-1
Großangriff	negative	-1
großartig	positive	1
Größenwahn	negative	-1
größenwahnsinnig	negative	-1
Großherzigkeit	positive	1
großherzig	positive	1
großkotzig	negative	-1
großmäulig	negative	-1
Großmut	positive	1
Großoffensive	negative	-1
groß	positive	0.7
großspurig	negative	-1
Großtat	positive	0.7
Großtuerei	negative	-1
Großzügigkeit	positive	1
großzügig	positive	0.7
grotesk	negative	-1
grüblerisch	negative	-1
grummeln	negative	-1
Grundbedürfnis	positive	1
gründlich	positive	1
grundlos	negative	-0.7
grundlos	negative	-1
Grundrecht	negative	-1
Gründung	positive	0.7
grüner_Star	negative	-0.7
Gruppentherapie	positive	0.7
gruselig	negative	-1
Grusel	negative	-1
gruseln	negative	-1
Guerillakrieg	negative	-1
günstig	positive	0.7
günstig	positive	1
Gunst	positive	1
Gürtelrose	negative	-0.7
gut_aufgelegt	positive	1
gut_betucht	positive	0.7
gutbetucht	positive	0.7
Güte	positive	0.7
Güte	positive	1
guter_Mut	positive	1
gutes_Gewissen	positive	1
gut_gelaunt	positive	1
gutgelaunt	positive	1
gutgemeint	positive	0.7
gut_geraten	positive	1
gutgeschrieben	positive	0.7
gutgläubig	negative	-0.7
gutheißen	positive	0.7
Gutherzigkeit	positive	1
gutherzig	positive	1
gütig	positive	1
gütlich	positive	1
Gutmütigkeit	positive	1
gutmütig	positive	1
gut	positive	1
gutsituiert	positive	0.7
gut_tun	positive	0.7
guttun	positive	0.7
Habenseite	positive	0.7
Habgier	negative	-1
habilitieren	positive	0.7
habilitiert_werden	positive	0.7
Hader	negative	-0.7
Haftentlassung	positive	0.7
Haft	negative	-1
Haftstrafe	negative	-1
Halbherzigkeit	negative	-0.7
halbherzig	negative	-0.7
halluzinieren	negative	-0.7
Halsschmerz	negative	-1
Halsweh	negative	-1
Haltbarmachung	positive	0.7
haltbar	positive	1
haltlos	negative	-0.7
Häme	negative	-1
hämisch	negative	-1
Hämorrhoiden	negative	-1
Hämorriden	negative	-1
Handelfmeter	negative	-0.7
Handelfmeter	negative	-1
Händel	negative	-0.7
Handelsembargo	negative	-0.7
Handelsembargo	negative	-1
Handelskrieg	negative	-1
handfest	positive	1
Handgemenge	negative	-1
handgreiflich	negative	-1
handhabbar	positive	0.7
handlich	positive	0.7
Handlungsbedarf	negative	-1
Handlungsfähigkeit	positive	0.7
handlungsfähig	positive	1
Handlungsunfähigkeit	negative	-0.7
handlungsunfähig	negative	-1
Handlungszwang	negative	-0.7
Handstreich	negative	-0.7
Handverletzung	negative	-0.7
hanebüchen	negative	-1
hänseln	negative	-1
Harmlosigkeit	negative	-0.7
Harm	negative	-1
Harmonie	positive	0.7
harmonisieren	positive	0.7
harsch	negative	-0.7
hartgesotten	negative	-1
Hartherzigkeit	negative	-1
hartherzig	negative	-1
hart	negative	-0.7
hart	positive	0.7
hassen	negative	-1
hasserfüllt	negative	-1
haßerfüllt	negative	-1
Hässlichkeit	negative	-0.7
Häßlichkeit	negative	-0.7
hässlich	negative	-1
häßlich	negative	-1
Hassliebe	negative	-0.7
Haßliebe	negative	-0.7
Hass	negative	-1
Haß	negative	-1
Haue	negative	-0.7
Hauptschuld	negative	-1
Hauptsorge	negative	-1
Hauptvorwurf	negative	-1
Hausbesetzung	negative	-0.7
Häuserkampf	negative	-0.7
Hausfriedensbruch	negative	-0.7
haushalten	positive	0.7
Haushaltskonsoldierung	positive	1
Haushaltssanierung	positive	0.7
Haushaltssanierung	positive	1
Haussegen	positive	0.7
Hausse	positive	0.7
Hautabschürfung	negative	-0.7
Hauterkrankung	negative	-1
Hautkrankheit	negative	-1
Hautkrebs	negative	-1
Hautreizung	negative	-0.7
Hautrötung	negative	-0.7
Hautunreinheit	negative	-0.7
Hebung	positive	0.7
hedonistisch	negative	-0.7
Hehlerei	negative	-0.7
hehr	positive	1
heilfroh	positive	1
Heiliger_Krieg	negative	-1
Heiligkeit	positive	0.7
Heilkraft	positive	0.7
heillos	negative	-0.7
heil	positive	1
Heil	positive	1
Heilung	positive	0.7
Heilung	positive	1
Heimatliebe	positive	0.7
Heimatlosigkeit	negative	-0.7
heimatlos	negative	-0.7
Heimatverbundenheit	positive	0.7
heimatverbunden	positive	0.7
heimelig	positive	1
heimlich	negative	-0.7
heimsuchen	negative	-1
Heimtücke	negative	-1
heimtückisch	negative	-1
Heimweh	negative	-1
heimzahlen	negative	-1
Heirat	positive	0.7
Heiratsantrag	positive	0.7
heischen	negative	-1
Heiserkeit	negative	-0.7
heiser	negative	-0.7
heiß	positive	0.7
Heiterkeit	positive	1
heiter	positive	0.7
heiter	positive	1
Hektik	negative	-1
hektisch	negative	-1
heldenhaft	positive	0.7
helfen	negative	-1
helfen	positive	0.7
hell	positive	0.7
hellwach	positive	0.7
Hemmung	negative	-0.7
hemmungslos	negative	-0.7
Henkung	negative	-0.7
Hepatitis	negative	-1
herablassend	negative	-0.7
herabsehen	negative	-0.7
herabsetzen	negative	-1
herabstufen	negative	-0.7
Herabstufung	negative	-1
herabwürdigen	negative	-1
Heraufsetzen	positive	0.7
Heraufsetzung	positive	0.7
herausekeln	negative	-1
herausragend	positive	1
herbeizitieren	negative	-0.7
hereinlegen	negative	-0.7
Heroinabhängigkeit	negative	-1
Heroinmissbrauch	negative	-1
Heroinmißbrauch	negative	-1
Heroinsucht	negative	-1
heroisch	positive	0.7
Herpes	negative	-0.7
herrenlos	negative	-0.7
herrisch	negative	-1
Herrlichkeit	positive	1
herrlich	positive	1
Herrschaftsanspruch	positive	0.7
herumfuhrwerken	negative	-0.7
herumhacken	negative	-1
herumhuren	negative	-1
herumtreiben	negative	-1
herumzicken	negative	-1
heruntergekommen	negative	-1
herunterkanzeln	negative	-1
heruntermachen	negative	-1
herunterspielen	negative	-1
herunterstufen	negative	-0.7
Herunterstufung	negative	-1
hervorragend	positive	1
Herzanfall	negative	-1
Herzattacke	negative	-1
Herzbeschwerden	negative	-1
herzbewegend	positive	0.7
Herzensangelegenheit	positive	0.7
Herzenserguss	positive	1
Herzenserguß	positive	1
herzergreifend	positive	0.7
Herzfehler	negative	-1
herziehen	negative	-1
Herzinfarkt	negative	-1
herzitieren	negative	-0.7
herzkrank	negative	-1
Herzlichkeit	positive	1
herzlich	positive	1
Herzlosigkeit	negative	-1
herzlos	negative	-1
Herzrhythmusstörung	negative	-1
Herzversagen	negative	-1
herzzerreißend	positive	0.7
Hetze	negative	-0.7
hetzerisch	negative	-1
Hetzkampagne	negative	-1
heucheln	negative	-1
heuchlerisch	negative	-1
heulen	negative	-1
Heulkrampf	negative	-1
Heuschnupfen	negative	-1
Hexenschuss	negative	-1
Hexenschuß	negative	-1
Hexenverbrennung	negative	-0.7
Hieb	negative	-0.7
high	negative	-0.7
Hilfestellung	positive	0.7
Hilflosigkeit	negative	-1
hilflos	negative	-0.7
hilflos	negative	-1
hilfreich	positive	1
Hilfsaktion	positive	0.7
hilfsbereit	positive	1
Hilfsbereitschaft	positive	1
Hilfsprogramm	positive	0.7
himmlisch	positive	1
hinausschmeißen	negative	-1
hinauswagen	positive	0.7
hinauswerfen	negative	-0.7
hinauswerfen	negative	-1
hinderlich	negative	-1
hindern	negative	-0.7
hineinknien	negative	-0.7
Hinfälligkeit	negative	-0.7
hinfällig	negative	-1
Hingabe	positive	1
hingebungsvoll	positive	0.7
hingerissen	positive	0.7
Hinken	negative	-0.7
hinnehmen	negative	-0.7
hinnehmen	positive	1
hinreichend	positive	0.7
hinreißend	positive	1
Hinrichtung	negative	-0.7
hintanstellen	negative	-0.7
hinterfotzig	negative	-1
hinterfragen	negative	-0.7
Hinterfragung	negative	-1
hintergehen	negative	-0.7
hintergründig	positive	1
hinterhältig	negative	-1
Hinterlistigkeit	negative	-1
hinterlistig	negative	-1
Hinterlist	negative	-1
hintertreiben	negative	-0.7
Hinterziehung	negative	-0.7
hinwegsehen	negative	-0.7
hinwegsetzen	negative	-0.7
Hinwendung	positive	0.7
Hirnhautentzündung	negative	-1
hirnlos	negative	-1
historischer_Krieg	negative	-1
hitzig	negative	-1
HIV	negative	-1
hochachten	positive	1
hoch_begabt	positive	1
hochbegabt	positive	1
hochfliegend	negative	-0.7
Hochform	positive	0.7
Hochgefühl	positive	1
hochgelobt	positive	1
Hochgenuss	positive	1
Hochgenuß	positive	1
hochkarätig	positive	0.7
hochkarätig	positive	1
hochklassig	positive	1
hochleben_lassen	positive	1
hochnäsig	negative	-0.7
hoch	positive	0.7
hochrangig	positive	0.7
Hochrüstung	negative	-1
Hochschulausbildung	positive	1
Hochschulreform	positive	1
Hochschulstudium	positive	1
hochsommerlich	positive	0.7
Höchstform	positive	0.7
hochstilisieren	negative	-0.7
Hochstimmung	positive	1
Höchststrafe	negative	-1
hochtrabend	negative	-0.7
Hochverrat	negative	-1
hochwertig	positive	1
Hochzeit	positive	0.7
Hochzeitsreise	positive	0.7
hochzufrieden	positive	1
Hodenkrebs	negative	-1
hoffähig	positive	1
hoffen	positive	0.7
Hoffnung	positive	1
hoffnungsfroh	positive	1
Hoffnungsfunke	positive	1
Hoffnungslosigkeit	negative	-1
hoffnungslos	negative	-1
Hoffnungsschimmer	positive	1
Hoffnungsstrahl	positive	1
hoffnungsvoll	positive	1
hofieren	positive	0.7
höfisch	positive	0.7
Höflichkeitsbesuch	positive	0.7
höflich	positive	1
Höhenangst	negative	-1
höhen	positive	0.7
höherqualifizieren	positive	0.7
höhnen	negative	-1
höhnisch	negative	-1
Hohn	negative	-1
Hokuspokus	negative	-0.7
Hokuspokus	negative	-1
hold	positive	1
Höllenstrafe	negative	-1
höllisch	negative	-1
Holocaust	negative	-0.7
Holocaust	negative	-1
Holzeinschlag	negative	-1
honett	positive	1
Honeymoon	positive	0.7
honorabel	positive	1
honorieren	positive	0.7
honorieren	positive	1
Hörbehinderung	negative	-1
Hörgenuss	positive	1
Hörgenuß	positive	1
Hörgerätereparatur	positive	1
Hörigkeit	negative	-1
Hornhautverkrümmung	negative	-1
Hornissenstich	negative	-0.7
Horror	negative	-1
Hörsturz	negative	-1
Hörvergnügen	positive	1
hübsch	positive	1
Hühnerauge	negative	-0.7
huldigen	negative	-1
humanitär	positive	1
Humanität	positive	1
human	positive	1
humorig	positive	1
humoristisch	positive	0.7
humorlos	negative	-0.7
humorlos	negative	-1
Humor	positive	1
humorvoll	positive	1
Hundebiss	negative	-1
Hundebiß	negative	-1
hungern	negative	-1
hungrig	positive	0.7
huren	negative	-1
Husten	negative	-0.7
Hyperaktivität	negative	-0.7
hypernervös	negative	-1
hypersensiblisieren	positive	1
Hysterie	negative	-1
hysterischer_Anfall	negative	-1
hysterisch	negative	-1
idealistisch	positive	1
ideal	positive	1
ideenlos	negative	-0.7
ideenreich	positive	1
Identitätskrise	negative	-1
Identitätsverlust	negative	-1
ideologiefrei	positive	0.7
idiotenhaft	negative	-1
idiotisch	negative	-1
idyllisch	positive	1
ignorant	negative	-1
ignorieren	negative	-0.7
Ikonoklasmus	negative	-1
Illegalität	negative	-1
Illegitimität	negative	-0.7
illegitim	negative	-1
illoyal	negative	-1
illusionär	negative	-1
illusionslos	negative	-1
illusorisch	negative	-1
imageträchtig	positive	1
Imageverlust	negative	-1
imaginär	negative	-1
Immunität	positive	0.7
immun	positive	1
Immunschwächekrankheit	negative	-1
Immunschwäche	negative	-1
impertinent	negative	-1
Impertinenz	negative	-1
Impetus	positive	0.7
Impfung	positive	0.7
imponierend	positive	1
Importverbot	negative	-0.7
Importverbot	negative	-1
imposant	positive	1
impotent	negative	-0.7
Impotenz	negative	-0.7
inadäquat	negative	-1
inakzeptabel	negative	-1
inbrünstig	positive	1
Inbrunst	positive	1
indifferent	negative	-1
Indifferenz	negative	-1
indigniert	negative	-1
indirekt	negative	-0.7
Indiskretion	negative	-0.7
indiskret	negative	-0.7
indisponibel	negative	-0.7
indizieren	negative	-1
Indoktrination	negative	-0.7
Industriespionage	negative	-0.7
Ineffizienz	negative	-0.7
Infamie	negative	-1
infam	negative	-1
Infarkt	negative	-1
Infektion	negative	-1
Infektionskrankheit	negative	-1
Infekt	negative	-1
infizieren	negative	-0.7
inflationär	negative	-1
Inflationsquote	negative	-0.7
Inflationsrate	negative	-0.7
informiert	positive	0.7
infragestellen	negative	-0.7
in_Frage_stellen	negative	-0.7
Infragestellung	negative	-1
Inhaftierung	negative	-0.7
Inhaftnahme	negative	-0.7
inhaltsleer	negative	-0.7
inhaltslos	negative	-0.7
Inhumanität	negative	-1
inhuman	negative	-1
inkompetent	negative	-1
inkonsequent	negative	-1
inkorrekt	negative	-1
innerer_Kampf	negative	-0.7
innerer_Konflikt	negative	-0.7
Innigkeit	positive	1
innig	positive	1
Innovation	positive	1
Innovationspolitik	positive	0.7
inplausibel	negative	-1
Inplausibilität	negative	-0.7
Insektenstich	negative	-0.7
inspirieren	positive	1
Inspiriertheit	positive	1
Instabilität	negative	-0.7
instabil	negative	-1
instandhalten	positive	0.7
Instandsetzung	positive	1
Instinktlosigkeit	negative	-0.7
Instrumentalisierung	negative	-0.7
integer	positive	1
Integrationskraft	positive	0.7
integrativ	positive	1
integrieren	positive	0.7
intellektuell	positive	0.7
intelligent	positive	1
interessant	positive	1
Interesselosigkeit	negative	-1
interesselos	negative	-0.7
Interessenkonflikt	negative	-0.7
interessenlos	negative	-0.7
interessieren	positive	1
interessiert	positive	1
Internierung	negative	-1
Intimität	positive	0.7
Intimität	positive	1
intolerant	negative	-1
intrigant	negative	-1
Intrige	negative	-0.7
intrigieren	negative	-1
introvertiert	negative	-1
Invasion	negative	-0.7
Inzest	negative	-1
Inzucht	negative	-1
ironisch	negative	-0.7
irrational	negative	-1
irreal	negative	-1
irreführend	negative	-1
Irreführung	negative	-0.7
Irreführung	negative	-1
irregeleitet	negative	-0.7
irregulär	negative	-1
irre	negative	-1
irren	negative	-1
irresein	negative	-1
Irrfahrt	negative	-0.7
Irritation	negative	-1
irritierend	negative	-1
Irritieren	negative	-1
irritiert	negative	-0.7
irrsinnig	negative	-1
irrtümlich	negative	-1
irrwitzig	negative	-1
Isolation	negative	-0.7
Isolation	negative	-1
Isolierung	negative	-0.7
jähzornig	negative	-1
jämmerlich	negative	-1
Jammer	negative	-1
jammern	negative	-1
jauchzen	positive	1
jeck	negative	-1
Jiu-Jitsu	positive	0.7
Joch	negative	-1
jovial	positive	0.7
jubeln	positive	1
jubilieren	positive	1
juchzen	positive	1
judenfeindlich	negative	-1
Judenmord	negative	-0.7
Judenverfolgung	negative	-0.7
Judenvernichtung	negative	-0.7
Judenvernichtung	negative	-1
Jugendkriminalität	negative	-1
Jugendlichkeit	positive	0.7
Jugendstrafe	negative	-1
Jugendsünde	negative	-0.7
Kaderschmiede	positive	0.7
Kaffeesucht	negative	-1
Kahlschlag	negative	-1
kalkulierbar	positive	0.7
Kaltblütigkeit	negative	-1
kaltblütig	negative	-1
kaltherzig	negative	-1
kalt	negative	-0.7
Kaltschnäuzigkeit	negative	-1
kaltschnäuzig	negative	-1
kaltstellen	negative	-0.7
kameradschaftlich	positive	1
Kamillebad	positive	0.7
Kammersprengung	negative	-1
kampferfahren	positive	0.7
kämpferisch	positive	1
kampferprobt	positive	0.7
kampfeslustig	negative	-1
kampflos	negative	-1
kampflustig	negative	-1
Kampf	negative	-0.7
Kanonenschuss	negative	-1
Kanonenschuß	negative	-1
Kapazitätsabbau	negative	-0.7
Kapitalerhöhung	positive	0.7
Kapitalverbrechen	negative	-0.7
Kapitalverbrechen	negative	-1
kapitulieren	negative	-0.7
kaprizieren	negative	-0.7
kapriziös	negative	-1
kaputtgehen	negative	-0.7
Kargheit	negative	-0.7
kärglich	negative	-0.7
Karies	negative	-1
kastrieren	negative	-0.7
Katarrh	negative	-1
Katarr	negative	-1
Katastrofenstimmung	negative	-1
katastrophal	negative	-1
Katastrophenstimmung	negative	-1
Katerstimmung	negative	-1
Katzenjammer	negative	-1
kaufen	negative	-0.7
käuflich	negative	-1
Kauflust	positive	1
Kaufrausch	negative	-0.7
Kauzigkeit	negative	-0.7
kauzig	negative	-1
Kavaliersdelikt	negative	-0.7
keck	positive	0.7
keifen	negative	-1
keifig	negative	-0.7
Keile	negative	-0.7
Keilerei	negative	-1
keimfrei	positive	0.7
kenntnislos	negative	-1
kenntnisreich	positive	1
Kernexplosion	negative	-1
kerngesund	positive	1
Kesseltreiben	negative	-1
keuchen	negative	-0.7
Keuchen	negative	-0.7
Keuchhusten	negative	-1
keusch	positive	1
kichern	positive	1
kiebig	negative	-0.7
Kieferbruch	negative	-1
Kindbettfieber	negative	-1
Kinderarbeit	negative	-1
Kinderbetreuung	negative	-1
Kinderfeindlichkeit	negative	-1
kinderfeindlich	negative	-1
Kinderfreundlichkeit	positive	1
kinderfreundlich	positive	1
Kinderhass	negative	-1
Kinderhaß	negative	-1
Kinderkrankheit	negative	-1
Kinderlähmung	negative	-1
Kindersterblichkeit	negative	-0.7
Kindesentführung	negative	-0.7
Kindesmissbrauch	negative	-0.7
Kindesmißbrauch	negative	-0.7
kindhaft	negative	-0.7
kindisch	negative	-0.7
Kindlichkeit	negative	-1
Kinogenuss	positive	1
Kinogenuß	positive	1
kirchliche_Hochzeit	positive	0.7
kirchliche_Trauung	positive	0.7
Kitsch	negative	-1
kläffen	negative	-1
klagen	negative	-1
kläglich	negative	-0.7
klammheimlich	negative	-0.7
Klangschönheit	positive	0.7
klapperdürr	negative	-0.7
klapprig	negative	-0.7
klären	positive	0.7
Klarheit	positive	0.7
klar	positive	0.7
klar	positive	1
Klassenkampf	negative	-0.7
Klassenressentiment	negative	-1
klasse	positive	1
klatschen	negative	-0.7
klatschsüchtig	negative	-0.7
Klaustrophobie	negative	-1
kleinbürgerlich	negative	-0.7
Kleinkrieg	negative	-1
Kleinkriminalität	negative	-0.7
kleinlaut	negative	-0.7
Kleinmut	negative	-1
Kleptomanie	negative	-1
Klimax	positive	0.7
Klinikum	positive	1
klischeehaft	negative	-1
Klonkrieg	negative	-1
klug	positive	1
knallhart	negative	-0.7
knatschig	negative	-1
Knatsch	negative	-1
knauserig	negative	-0.7
knausrig	negative	-0.7
Knechtschaft	negative	-1
Knetkur	positive	0.7
knickerig	negative	-0.7
knickrig	negative	-0.7
Knieverletzung	negative	-0.7
Knochenbruch	negative	-1
Knochenschwund	negative	-1
knochentrocken	negative	-0.7
knorke	positive	1
knotig	negative	-1
knuffig	positive	0.7
Koalitionsstreit	negative	-0.7
Koffeinabhängigkeit	negative	-1
Koffeinmissbrauch	negative	-1
Koffeinmißbrauch	negative	-1
Koffeinsucht	negative	-1
Kokainabhangigkeit	negative	-1
Kokainmissbrauch	negative	-1
Kokainmißbrauch	negative	-1
Kokainsucht	negative	-1
Koketterie	negative	-0.7
Kolik	negative	-1
kollabieren	negative	-0.7
Kollaps	negative	-1
kollegial	positive	0.7
Kollektivschuld	negative	-1
Koller	negative	-1
Kolonialherrschaft	negative	-1
Kolonisation	positive	0.7
Kolonisierung	positive	0.7
komatös	negative	-1
komfortabel	positive	0.7
Komfort	positive	0.7
komisch	negative	-0.7
komisch	negative	-1
komisch	positive	1
kommunikationsfreudig	positive	1
kommunikativ	positive	1
kommunistenfrei	negative	-0.7
kompetent	positive	1
Komplex	negative	-0.7
komplikationslos	positive	0.7
Kompliment	positive	1
kompliziert	negative	-0.7
kompromissbereit	positive	0.7
kompromißbereit	positive	0.7
kompromittieren	negative	-1
Konfliktfähigkeit	positive	1
konfliktfähig	positive	1
konfliktfrei	positive	0.7
konfliktlos	positive	0.7
konform	positive	1
Konfrontationstherapie	positive	0.7
konfus	negative	-0.7
kongenial	positive	1
Konjunkturaufschwung	positive	0.7
Konkurrenzfähigkeit	positive	0.7
konkurrenzfähig	positive	1
konsequent	positive	0.7
Konservierung	positive	0.7
Konsilidieren	positive	1
Konsolidation	positive	1
Konsolidierung	positive	1
konspirativ	negative	-0.7
konspirieren	negative	-0.7
konsternieren	negative	-1
Konstituierung	positive	0.7
konstruktiv	positive	1
Konsumrausch	negative	-0.7
kontaktarm	negative	-0.7
Kontaktarmut	negative	-0.7
Kontaktfreude	positive	0.7
Kontaktfreudigkeit	positive	0.7
kontaktfreudig	positive	1
Kontaktlosigkeit	negative	-1
Kontaktpflege	positive	0.7
Kontaktschwierigkeiten	negative	-0.7
Kontenance	positive	0.7
konterkarieren	negative	-0.7
kontrovers	negative	-1
konvertieren	positive	0.7
konzentriert	positive	1
Konzeptionslosigkeit	negative	-0.7
konzeptionslos	negative	-0.7
Konzeptlosigkeit	negative	-0.7
Konzertgenuss	positive	1
Konzertgenuß	positive	1
Konzession	positive	0.7
kopflos	negative	-0.7
Kopfschmerz	negative	-1
Kopfschuss	negative	-1
Kopfschuß	negative	-1
Kopfverletzung	negative	-0.7
Kopfweh	negative	-1
körperbehindert	negative	-1
Körperbehinderung	negative	-1
körperlich_beeinträchtigt	negative	-1
körperlich_behindert	negative	-1
körperliche_Beeinträchtigung	negative	-1
körperliches_Wohlgefühl	positive	1
Körperproblem	negative	-1
Körperverletzung	negative	-0.7
Körperverletzung	negative	-1
korpulent	negative	-0.7
Korrektheit	positive	1
korrekt	positive	1
korrigieren	positive	0.7
korrumpieren	negative	-1
Korruptheit	negative	-1
Korruption	negative	-0.7
Korruption	negative	-1
korruptionsfrei	positive	1
korrupt	negative	-1
Kostbarkeit	positive	1
kostbar	positive	1
Kostendruck	negative	-0.7
kostengünstig	positive	1
kostenintensiv	negative	-1
kostenlos	positive	0.7
Kostensteigerung	positive	0.7
kostspielig	negative	-1
kotzen	negative	-0.7
Krach	negative	-0.7
Krach	negative	-1
kraftlos	negative	-0.7
Kraftmeierei	negative	-1
Kraft	positive	0.7
kraftvoll	positive	0.7
krakeelen	negative	-1
Krampfader	negative	-1
Krampfanfall	negative	-1
krampfhaft	negative	-0.7
krampfig	negative	-0.7
Krampf	negative	-1
kränkelnd	negative	-1
kränkeln	negative	-0.7
Krankengymnastik	positive	0.7
krankenhausreif	negative	-1
kranken	negative	-0.7
kränken	negative	-1
Krankenversorgung	positive	0.7
krankhaft	negative	-1
Krankheit	negative	-1
kränklich	negative	-1
krank	negative	-1
Krankwerden	negative	-1
krass	positive	0.7
Krätze	negative	-0.7
Kratzer	negative	-0.7
Kratzwunde	negative	-0.7
Krawall	negative	-0.7
Krawall	negative	-1
Kreation	positive	0.7
Kreativität	positive	1
kreativ	positive	1
krebsen	negative	-0.7
Krebserkrankung	negative	-1
Krebsgeschwür	negative	-1
krebskrank	negative	-1
Krebsleiden	negative	-1
Krebs	negative	-1
Krebsvorsorge	positive	0.7
Krebszelle	negative	-1
Kreditbetrug	negative	-0.7
Kreditbetrug	negative	-1
Kreditgewährung	positive	1
Kreditwürdigkeit	positive	0.7
Kreislaufkollaps	negative	-1
Kreuzigung	negative	-0.7
Kreuzzug	negative	-1
kriechen	negative	-0.7
kriecherisch	negative	-1
kriegerisch	negative	-1
Krieg	negative	-1
Kriegsbegeisterung	negative	-1
Kriegsbeute	negative	-1
kriegsfrei	positive	0.7
Kriegsgefangenschaft	negative	-1
Kriegsgräuel	negative	-0.7
Kriegsgreuel	negative	-0.7
Kriegsmaschinerie	negative	-1
Kriegsverbrechen	negative	-0.7
Kriegswirren	negative	-0.7
kriminalisieren	negative	-1
Kriminalität	negative	-1
kriminalitätsfrei	positive	0.7
Kriminalitätsrate	negative	-1
kriminelle_Handlung	negative	-0.7
kriminell	negative	-1
Krisenausschuss	positive	1
Krise	negative	-1
krisenerfahren	positive	1
krisenerprobt	positive	1
krisenerschüttert	positive	1
krisengebeutelt	positive	1
krisengeschüttelt	positive	1
Krisenstab	positive	1
Krisenstimmung	negative	-0.7
Krisenstimmung	negative	-1
Krisis	negative	-1
kritisieren	negative	-1
krümmen	negative	-1
krumm_nehmen	negative	-1
krummnehmen	negative	-1
krüppelhaft	negative	-0.7
krüppelig	negative	-0.7
Kuckucksei	negative	-0.7
Kuddelmuddel	negative	-1
Kugelhagel	negative	-1
kühl	negative	-0.7
Kühnheit	positive	0.7
kühn	positive	0.7
kujonieren	negative	-1
Kultivierung	positive	0.7
Kulturerbe	positive	0.7
Kulturgenuss	positive	1
Kulturgenuß	positive	1
Kulturkampf	negative	-0.7
kulturlos	negative	-0.7
Kulturschatz	positive	0.7
Kulturschock	negative	-1
kümmerlich	negative	-1
Kummer	negative	-1
kümmern	negative	-1
kümmern	positive	0.7
Kumpanei	negative	-0.7
Kumpanei	negative	-1
kumpelhaft	positive	0.7
Kundenbetreuung	negative	-1
Kundenfeindlichkeit	negative	-1
Kundenfreundlichkeit	positive	1
kündigen	negative	-0.7
kundig	positive	1
kungeln	negative	-0.7
kunstbegeistert	positive	1
kunstfertig	positive	1
Kunstgenuss	positive	1
Kunstgenuß	positive	1
kunstinteressiert	positive	1
kunstvoll	positive	1
Kuraufenthalt	positive	0.7
kurios	negative	-1
Kurlaub	positive	0.7
Kur	positive	0.7
Kurtherapie	positive	0.7
Kurzatmigkeit	negative	-1
Kurzschlusshandlung	negative	-1
Kurzschlußhandlung	negative	-1
Kurzschluss	negative	-0.7
Kurzschluß	negative	-0.7
Kurzschlusstat	negative	-1
Kurzschlußtat	negative	-1
Kurzsichtigkeit	negative	-0.7
kurzsichtig	negative	-0.7
Kurzweile	negative	-1
kurzweilig	positive	1
kuschen	negative	-0.7
labern	negative	-1
labil	negative	-1
Lachanfall	negative	-1
lächeln	positive	1
Lachen	positive	0.7
lachen	positive	1
Lächerlichkeit	negative	-1
lächerlich	negative	-1
Lacher	positive	0.7
lachhaft	negative	-1
Lachkrampf	negative	-1
lädieren	negative	-1
lädiert	negative	-1
Ladungssicherung	positive	0.7
lähmen	negative	-1
Lahmheit	negative	-0.7
lahm	negative	-1
Lahmsein	negative	-0.7
Lähmung	negative	-1
laienhaft	negative	-1
lamentieren	negative	-1
Lampenfieber	negative	-1
Landeerlaubnis	positive	0.7
Landesverrat	negative	-1
Landesverteidigung	positive	0.7
Landesverweis	negative	-1
Landfriedensbruch	negative	-0.7
Landreform	positive	1
Landwirtschaftsreform	positive	1
Langeweile	negative	-1
Langmut	positive	0.7
langsam	negative	-0.7
langweilen	negative	-1
Langweiligkeit	negative	-1
langweilig	negative	-1
langzeitarbeitslos	negative	-0.7
lärmfrei	positive	1
Lärm	negative	-0.7
lasch	negative	-0.7
lässig	positive	0.7
lasten	negative	-1
lasterhaft	negative	-1
Laster	negative	-1
lästern	negative	-1
lästig	negative	-1
lasziv	negative	-1
latent	negative	-0.7
Laune	negative	-1
launenhaft	negative	-1
launig	negative	-1
launisch	negative	-1
lausbubenhaft	positive	0.7
lausbübisch	positive	0.7
läutern	positive	1
lauter	positive	1
lautstark	negative	-0.7
lebendig	positive	0.7
lebensbejahend	positive	1
lebenserfahren	positive	1
Lebensfähigkeit	positive	0.7
lebensfähig	positive	1
lebensfern	negative	-1
Lebensfreude	positive	1
lebensfroh	positive	1
Lebensgenuss	positive	1
Lebensgenuß	positive	1
Lebensglück	positive	1
lebenslustig	positive	1
Lebenslust	positive	1
Lebensmittelvergiftung	negative	-1
lebensmüde	negative	-1
Lebensmüdigkeit	negative	-1
Lebensmut	positive	1
Lebensrecht	positive	0.7
lebenstüchtig	positive	1
lebensunfähig	negative	-1
lebensuntüchtig	negative	-0.7
Leberentzündung	negative	-1
leberkrank	negative	-1
Leberkrebs	negative	-1
lebhaft	positive	0.7
leblos	negative	-1
leer	negative	-1
legalisieren	positive	0.7
Legalisierung	positive	0.7
Legalität	positive	0.7
legendär	positive	1
legendenhaft	positive	1
leger	negative	-0.7
Legitimation	positive	0.7
legitimieren	positive	0.7
Legitimität	positive	0.7
legitim	positive	1
Lehrbefähigung	positive	1
Lehre	negative	-1
Lehrerausbildung	positive	1
Lehrerbetreuung	negative	-1
lehrerhaft	negative	-1
lehrreich	positive	1
Leibeigenschaft	negative	-1
Leiche	negative	-0.7
Leichnam	negative	-0.7
Leichtfertigkeit	negative	-0.7
leichtfertig	negative	-1
leichtfüßig	positive	1
Leichtgläubig	negative	-0.7
Leichtheit	positive	0.7
leichtsinnig	negative	-1
Leichtsinn	negative	-1
leidend	negative	-1
leiden	negative	-1
Leiden	negative	-1
Leidenschaft	negative	-1
Leidenschaft	positive	1
leidenschaftslos	negative	-0.7
leidgeplagt	negative	-1
leidgeprüft	negative	-1
leidig	negative	-1
Leid	negative	-1
leidtragend	negative	-1
Leid_tragend	negative	-1
leid_tun	negative	-1
Leid_tun	negative	-1
leidvoll	negative	-1
leimen	negative	-0.7
Leistungsanspruch	positive	0.7
Leistungsdruck	negative	-0.7
leistungsfähig	positive	0.7
Leistungssteigerung	positive	0.7
Lektion	negative	-1
Lepra	negative	-1
Lernbehinderung	negative	-1
lernfähig	positive	1
lesbar	positive	1
Lesegenuss	positive	1
Lesegenuß	positive	1
lesenswert	positive	1
Lesevergnügen	positive	1
Lethargie	negative	-1
Leuchtkraft	positive	0.7
Leukämie	negative	-1
Liberalisierung	positive	0.7
Liberalisierung	positive	1
liberal	positive	0.7
libidonös	negative	-1
Lichtblick	positive	1
Liebedienerei	positive	1
lieben	positive	1
liebenswert	positive	1
liebenswürdig	positive	1
Liebe	positive	1
Liebesbeziehung	positive	1
Liebesdienst	positive	0.7
liebesfähig	positive	1
Liebesheirat	positive	0.7
Liebeskummer	negative	-1
liebevoll	positive	1
liebhaben	positive	1
Lieblichkeit	positive	1
lieblich	positive	1
Lieblingsbeschäftigung	positive	1
Lieblingsfarbe	positive	1
Lieblingsmusik	positive	1
Lieblingsobjekt	positive	1
Lieblingssache	positive	1
Lieblingsschauspieler	positive	1
Lieblosigkeit	negative	-1
lieblos	negative	-0.7
lieblos	negative	-1
lieb	positive	1
liebreizend	positive	1
liederlich	negative	-1
limitiert	negative	-1
Linderung	positive	0.7
linientreu	positive	1
linken	negative	-0.7
linkisch	negative	-1
link	negative	-0.7
linksextremistisch	negative	-1
linksextrem	negative	-1
linkslastig	negative	-1
linksradikal	negative	-1
Linksruck	negative	-1
Lippenbekenntnis	positive	0.7
Liquidation	negative	-0.7
Liquidierung	negative	-0.7
literaturbegeistert	positive	1
literaturinteressiert	positive	1
loben	positive	1
lobenswert	positive	0.7
Lobeshymne	positive	1
löblich	positive	0.7
Lob	positive	1
lobpreisen	positive	1
Lobpreisung	positive	1
locker	positive	0.7
locker	positive	1
logisch	positive	1
lohnend	positive	1
lohnenswert	positive	1
Lohnerhöhung	positive	0.7
Lohnsteigerung	positive	0.7
losbrüllen	negative	-1
loslachen	positive	1
lossagen	negative	-1
lossprechen	positive	0.7
lossprechen	positive	1
Lösungsvorschlag	positive	0.7
loyal	positive	1
luderhaft	negative	-1
Luftkampf	negative	-0.7
Luftkrieg	negative	-1
Luftreinhaltung	positive	0.7
Lüge	negative	-1
lügen	negative	-1
lügnerisch	negative	-1
lukrativ	positive	1
lümmelhaft	negative	-1
lumpig	negative	-1
Lungendurchschuss	negative	-1
Lungendurchschuß	negative	-1
Lungenentzündung	negative	-1
Lungenerkrankung	negative	-1
Lungenkrankheit	negative	-1
lungenkrank	negative	-1
Lungenkrebs	negative	-1
Lungenstiche	negative	-1
Lungentuberkulose	negative	-1
lustbetont	positive	1
lüstern	negative	-0.7
lustig_machen	negative	-1
lustig	positive	1
Lustlosigkeit	negative	-1
lustlos	negative	-0.7
Lust	positive	1
lustvoll	positive	1
Lynchjustiz	negative	-1
Machenschaft	negative	-1
Machtanspruch	positive	0.7
Machtergreifung	negative	-1
Machterhalt	positive	0.7
Machterhaltung	positive	0.7
Machtgier	negative	-1
mächtig	positive	0.7
Machtkampf	negative	-0.7
Machtlosigkeit	negative	-1
machtlos	negative	-1
Machtspiel	negative	-0.7
Machtverlust	negative	-1
machtvoll	positive	0.7
Machtwettkampf	negative	-0.7
Machwerk	negative	-1
Macke	negative	-0.7
Magengeschwür	negative	-1
magenkrank	negative	-1
Magenkrebs	negative	-1
Magenschmerz	negative	-1
magersüchtig	negative	-1
Magersucht	negative	-1
magisch	positive	0.7
mahnen	negative	-1
Mahngebühr	negative	-1
Mahnung	negative	-1
Majestätsbeleidigung	negative	-1
makaber	negative	-1
Makellosigkeit	positive	1
makellos	positive	0.7
mäkeln	negative	-1
Malaria	negative	-1
malerisch	positive	0.7
maliziös	negative	-1
Maloche	negative	-1
malträtieren	negative	-1
Mandelentzündung	negative	-1
Mangelernährung	negative	-1
Mangelerscheinung	negative	-1
mangelfrei	positive	0.7
Mangelhaftigkeit	negative	-1
Mangel	negative	-1
Mängelrüge	negative	-1
Manie	negative	-1
manieriert	negative	-0.7
manierlich	positive	0.7
Manipulation	negative	-0.7
Manipulierung	negative	-0.7
manisch-depressiv	negative	-1
manische_Depression	negative	-1
manisch	negative	-1
Männerfeindlichkeit	negative	-1
Männerfreundschaft	positive	0.7
Männerhass	negative	-1
Männerhaß	negative	-1
mannigfaltig	positive	0.7
mannschaftsdienlich	positive	1
mannschaftstauglich	positive	1
märchenhaft	positive	1
marginalisieren	negative	-1
markieren	negative	-0.7
marktbeherrschend	positive	1
marktführend	positive	1
Marter	negative	-1
martern	negative	-1
martialisch	negative	-1
Martyrium	negative	-1
Maschinenreparatur	positive	1
Masern	negative	-1
Masochismus	negative	-1
masochistisch	negative	-1
Massage	positive	0.7
Massaker	negative	-0.7
Massaker	negative	-1
Massenhysterie	negative	-1
Massenmord	negative	-0.7
Massenmord	negative	-1
Massenschlägerei	negative	-1
Massenvernichtung	negative	-0.7
Massenvernichtung	negative	-1
Maßgenauigkeit	positive	0.7
mäßigen	positive	1
massiv	negative	-1
Maßlosigkeit	negative	-1
maßlos	negative	-1
maßregeln	negative	-1
Maßregelung	negative	-1
maßvoll	positive	1
Mattheit	negative	-0.7
Mattigkeit	negative	-0.7
matt	negative	-0.7
maulen	negative	-1
Maulkorb	negative	-0.7
Maul-_und_Klauenseuche	negative	-0.7
mau	negative	-1
Mauschelei	negative	-0.7
Mauschelei	negative	-1
mauscheln	negative	-0.7
mausetot	negative	-1
maximal	positive	0.7
meckern	negative	-1
Medienrummel	negative	-0.7
Medienspektakel	positive	0.7
Medikamenteneinnahme	negative	-1
Medikamentenkonsum	negative	-1
mediterran	positive	0.7
Mehltau	negative	-0.7
mehrheitsfähig	positive	1
Meineid	negative	-1
Meinungsäußerungsverbot	negative	-0.7
Meinungsfreiheit	positive	0.7
Meinungsmache	negative	-0.7
Meinungsstreit	negative	-0.7
Meinungsverschiedenheit	negative	-0.7
meisterhaft	positive	1
meisterlich	positive	1
Melancholie	negative	-1
melancholisch	negative	-1
Melanom	negative	-1
memmenhaft	negative	-1
Meniskusentzündung	negative	-1
menschenfeindlich	negative	-1
Menschenfreundlichkeit	positive	1
menschenfreundlich	positive	1
Menschenhandel	negative	-0.7
Menschenliebe	positive	1
Menschenrecht	positive	0.7
Menschenrechtsverletzung	negative	-0.7
Menschenrechtsverletzung	negative	-1
menschenscheu	negative	-0.7
Menschenschmuggel	negative	-0.7
menschenunwürdig	negative	-1
menschenverachtend	negative	-1
menschenwürdig	positive	1
Menschlichkeit	positive	1
menschlich	positive	1
Menstruationsbeschwerden	negative	-1
merkwürdig	negative	-1
Messerkampf	negative	-0.7
Messerstecherei	negative	-0.7
Messerstich	negative	-0.7
metastasieren	negative	-1
Methadonprogramm	positive	0.7
methodisch	positive	0.7
Meuchelmord	negative	-0.7
Meuterei	negative	-0.7
mickrig	negative	-1
Mief	negative	-0.7
miesepetrig	negative	-1
miesmachen	negative	-1
mies	negative	-1
Mieterhöhung	positive	0.7
Mietsteigerung	positive	0.7
Mietzinserhöhung	positive	0.7
Migräne	negative	-1
Milchschorf	negative	-0.7
Milde	positive	1
mildernd	positive	1
Milderung	positive	0.7
mild	positive	1
Mildtätigkeit	positive	1
militant	negative	-1
militärischer_Schlag	negative	-0.7
militärischer_Schlag	negative	-1
Militarisierung	negative	-1
Militärputsch	negative	-0.7
Militärsanktion	negative	-1
Militärschlag	negative	-0.7
Militärschlag	negative	-1
milliardenschwer	positive	0.7
millionenschwer	positive	0.7
mimosenhaft	negative	-1
minderbegabt	negative	-1
minderbemittelt	negative	-1
Minderung	negative	-0.7
Minderwertigkeitsgefühl	negative	-1
Minderwertigkeitskomplex	negative	-1
minderwertig	negative	-1
Mindestsicherung	positive	0.7
Mindeststrafe	negative	-1
Minenexplosion	negative	-1
Mineralölsteuererhöhung	positive	0.7
minimal	negative	-1
miserabel	negative	-1
missachten	negative	-1
mißachten	negative	-1
Missbehagen	negative	-1
Mißbehagen	negative	-1
Missbildung	negative	-1
Mißbildung	negative	-1
missbilligen	negative	-1
mißbilligen	negative	-1
missbrauchen	negative	-1
mißbrauchen	negative	-1
Missbrauch	negative	-0.7
Mißbrauch	negative	-0.7
Missbrauch	negative	-1
Mißbrauch	negative	-1
missdeuten	negative	-1
mißdeuten	negative	-1
Missetat	negative	-0.7
Missfallen	negative	-1
Mißfallen	negative	-1
missfällig	negative	-1
mißfällig	negative	-1
missgebildet	negative	-1
mißgebildet	negative	-1
missgelaunt	negative	-1
mißgelaunt	negative	-1
missgestimmt	negative	-1
mißgestimmt	negative	-1
missgönnen	negative	-1
mißgönnen	negative	-1
missgünstig	negative	-1
Missgunst	negative	-1
Mißgunst	negative	-1
misshandeln	negative	-1
mißhandeln	negative	-1
Misshandlung	negative	-0.7
Mißhandlung	negative	-0.7
Misshandlung	negative	-1
Mißhandlung	negative	-1
missionieren	positive	0.7
misslaunig	negative	-1
mißlaunig	negative	-1
misslich	negative	-1
mißlich	negative	-1
missliebig	negative	-1
mißliebig	negative	-1
misslungen	negative	-1
mißlungen	negative	-1
Missmut	negative	-1
Mißmut	negative	-1
missraten	negative	-1
mißraten	negative	-1
misstrauen	negative	-1
Misstrauen	negative	-1
mißtrauen	negative	-1
Mißtrauen	negative	-1
misstrauisch	negative	-1
mißtrauisch	negative	-1
Missvergnügen	negative	-1
Mißvergnügen	negative	-1
missverstanden	negative	-1
mißverstanden	negative	-1
missverstehen	negative	-1
mißverstehen	negative	-1
mistig	negative	-1
mitbestimmen	positive	0.7
Mitempfindung	positive	1
mitentscheiden	positive	0.7
mitfühlend	positive	1
mitfühlen	positive	1
Mitgefühl	positive	1
mitgenommen	negative	-1
Mitgliedsbetreuung	negative	-1
mithelfen	positive	0.7
mitleidend	positive	1
Mitleidenschaft	negative	-0.7
mitleiderregend	negative	-1
Mitleid_erregend	negative	-1
Mitleidlosigkeit	negative	-1
mitleidlos	negative	-1
Mitleid	positive	1
mitleidslos	negative	-0.7
Mitmenschlichkeit	positive	1
mitreißen	positive	1
mitschuldig	negative	-1
Mitschuld	negative	-1
mitteilsam	positive	1
mittellos	negative	-0.7
Mittelmäßigkeit	negative	-0.7
Mittelohrentzündung	negative	-1
mittragen	positive	1
mitverantworten	positive	1
MKS	negative	-0.7
mobben	negative	-1
moderat	positive	1
Modernisierung	positive	0.7
Modernisierungspolitik	positive	0.7
Mogelei	negative	-0.7
Mogelei	negative	-1
mogeln	negative	-0.7
Mogelpackung	negative	-0.7
Mogelpackung	negative	-1
mögen	positive	1
mondän	positive	0.7
mondsüchtig	negative	-1
monieren	negative	-1
Monotonie	negative	-1
monoton	negative	-0.7
monströs	negative	-1
mopsen	negative	-1
moralisch	positive	1
moralisieren	positive	0.7
morbide	negative	-1
Mordanschlag	negative	-0.7
mörderisch	negative	-1
Mordfall	negative	-0.7
Mordgier	negative	-1
Mordlust	negative	-1
Mord	negative	-0.7
Mordtat	negative	-0.7
Morphiumsucht	negative	-1
Moskitostich	negative	-0.7
motivieren	positive	0.7
motivieren	positive	1
motiviert	positive	1
MS	negative	-1
Mückenstich	negative	-0.7
müde	negative	-1
Müdigkeit	negative	-0.7
muffelig	negative	-1
Muffe	negative	-1
Muffensausen	negative	-1
Muffigkeit	negative	-0.7
muffig	negative	-1
Muff	negative	-0.7
mühelos	positive	0.7
mühen	negative	-1
Müllbeseitigung	negative	-1
Müllentsorgung	negative	-1
müllfrei	positive	0.7
Müllverbrennung	negative	-1
Müllwirtschaft	negative	-1
mulmiges_Gefühl	negative	-1
mulmig	negative	-1
multiple_Persönlichkeitsspaltung	negative	-1
Multiple_Sklerose	negative	-1
Mumm	positive	0.7
Mumps	negative	-1
Mündigkeit	positive	0.7
munter	positive	0.7
munter	positive	1
murren	negative	-1
mürrisch	negative	-1
musikalisch	positive	1
musikbegabt	positive	1
musikbegeistert	positive	1
Musikgenuss	positive	1
Musikgenuß	positive	1
musikinteressiert	positive	1
Muskelfaserriss	negative	-0.7
Muskelfaserriß	negative	-0.7
Muskelgeschwulst	negative	-1
Muskelkater	negative	-1
Muskelkrampf	negative	-1
Muskelverspannung	negative	-0.7
mustergültig	positive	1
musterhaft	positive	0.7
mutig	positive	1
Mutlosigkeit	negative	-1
mutlos	negative	-1
Mut	positive	1
Mütterkur	positive	0.7
mütterlich	positive	0.7
Mutwilligkeit	negative	-0.7
mystisch	positive	0.7
mythisch	positive	1
nachahmenswert	positive	1
Nachbesserung	positive	0.7
Nachbetreuung	negative	-1
nachempfinden	positive	1
nachgeben	negative	-0.7
nachgiebig	positive	1
Nachhaltigkeit	positive	0.7
Nachholbedarf	negative	-1
Nachlässigkeit	negative	-0.7
nachlässig	negative	-1
Nachrüstung	negative	-1
Nachrüstung	positive	0.7
nachsagen	negative	-1
Nachsorgekur	positive	0.7
Nachsorge	negative	-1
Nächstenliebe	positive	1
Nachteil	negative	-1
nachtragend	negative	-0.7
nachtragen	negative	-1
nachtrauern	negative	-1
Nacht-und-Nebel-Aktion	negative	-0.7
nachweinen	negative	-1
Nachwuchsförderung	positive	0.7
Nackenfett	negative	-1
Nackenspeck	negative	-1
Nagelpilz	negative	-0.7
Nahkampf	negative	-0.7
Nahostkonflikt	negative	-0.7
nah	positive	1
Nahrungsmittelallergie	negative	-1
Naivität	negative	-1
naiv	negative	-0.7
Narbe	negative	-1
narrenhaft	negative	-1
narren	negative	-1
närrisch	negative	-1
Nasenbeinbruch	negative	-1
Nasenbluten	negative	-1
nationalistisch	negative	-1
Naturgenuss	positive	1
Naturgenuß	positive	1
natürlich	positive	0.7
Naturrecht	positive	0.7
Naturschönheit	positive	0.7
Naturschutzaktion	positive	0.7
Naturschutzaktion	positive	1
nebligtrüb	negative	-0.7
necken	negative	-1
negativer_Besitz	negative	-0.7
negativ	negative	-1
negieren	negative	-1
neiden	negative	-1
neidisch	negative	-1
neidlos	positive	0.7
Neid	negative	-1
Neigung	positive	1
Nekrophilie	negative	-1
nekrophil	negative	-1
neofaschistisch	negative	-1
neonazistisch	negative	-1
Nepotismus	negative	-0.7
Nepotismus	negative	-1
neppen	negative	-0.7
Nepp	negative	-0.7
Nepp	negative	-1
Nervenentzündung	negative	-1
Nervenkollaps	negative	-1
Nervenkrieg	negative	-1
nerven	negative	-1
Nervenstärke	positive	1
Nervenzusammenbruch	negative	-1
nervig	negative	-1
Nervosität	negative	-1
nervös	negative	-1
Nesselfieber	negative	-1
Nettigkeit	positive	1
nett	positive	1
Neuansiedlung	positive	0.7
Neuaufnahme	positive	0.7
Neuausrichtung	positive	0.7
Neubeginn	positive	0.7
Neubereifung	positive	0.7
Neubildung	positive	0.7
Neueinstellung	positive	0.7
Neuentwicklung	positive	0.7
Neuerung	positive	0.7
Neuerwerbung	positive	0.7
neu_gestalten	positive	0.7
neugestalten	positive	0.7
Neugierde	positive	0.7
Neugier	positive	0.7
Neugliederung	positive	0.7
Neuordnung	positive	0.7
Neuorganisation	positive	0.7
Neuplanung	positive	0.7
Neuregelung	positive	0.7
Neurodermitis	negative	-0.7
Neurose	negative	-1
neurotisch	negative	-1
neurotisieren	negative	-0.7
Neuverteilung	positive	0.7
Nichteinhaltung	negative	-1
Nichterfüllung	negative	-1
Nichtsein	negative	-0.7
nicht_seßhaft	negative	-1
Nichts	negative	-0.7
nichts_sagend	negative	-1
nichtssagend	negative	-1
niederdrücken	negative	-1
niedergedrückt	negative	-0.7
Niedergeschlagenheit	negative	-1
niedergeschlagen	negative	-0.7
niederhalten	negative	-1
niederlagenfrei	positive	0.7
Niederlassungsfreiheit	positive	0.7
nieder	negative	-0.7
Niederreißung	negative	-1
niederschmetternd	negative	-1
Niederträchtigkeit	negative	-1
niederträchtig	negative	-1
Niedertracht	negative	-1
niedlich	positive	0.7
niedrig	negative	-0.7
Nierenbeckenentzündung	negative	-1
nierenkrank	negative	-1
Nierenstein	negative	-0.7
Nierenvergiftung	negative	-1
Nikotinabhängigkeit	negative	-1
Nikotinmissbrauch	negative	-1
Nikotinmißbrauch	negative	-1
Nikotinsucht	negative	-1
niveaulos	negative	-0.7
nobel	positive	0.7
nobilitieren	positive	0.7
Noblesse	positive	1
nölen	negative	-1
nölig	negative	-1
nominell	negative	-1
nonchalent	positive	0.7
nörgelig	negative	-1
nörgeln	negative	-1
nörglerisch	negative	-1
normalisieren	positive	1
normal	positive	0.7
Notbremse	negative	-1
notdürftig	negative	-1
nötigen	negative	-1
notleidend	negative	-0.7
Not_leidend	negative	-0.7
Not	negative	-1
Notstand	negative	-0.7
Notstand	negative	-1
Novelle	positive	1
nüchtern	positive	0.7
nutzbringend	positive	1
Nutzen	positive	1
Nützlichkeit	positive	1
nützlich	positive	1
Nutzlosigkeit	negative	-1
nutzlos	negative	-1
Nutznießung	positive	1
Nymphomanie	negative	-1
obdachlos	negative	-1
oberflächlich	negative	-0.7
oberflächlich	negative	-1
Oberschenkelhalsbruch	negative	-1
Oberstufenreform	positive	1
objektiv	positive	1
Obsession	negative	-1
obskur	negative	-1
Obszönität	negative	-1
obszön	negative	-1
öde	negative	-1
öden	negative	-1
Ödheit	negative	-1
Odyssee	negative	-0.7
offenbaren	positive	0.7
Offenheit	positive	1
offenherzig	positive	1
offen	positive	0.7
Offensive	negative	-1
Offerte	positive	0.7
Ohnmächtigkeit	negative	-1
ohnmächtig	negative	-1
Ohnmacht	negative	-1
Ohnmachtsgefühl	negative	-1
Ohrenschmerz	negative	-1
Ohrenweh	negative	-1
Okkupation	negative	-0.7
Ölembargo	negative	-0.7
Ölembargo	negative	-1
ölig	negative	-0.7
oll	negative	-1
omnipotent	positive	1
opportunistisch	negative	-0.7
opportun	positive	1
optimal	positive	1
Optimierung	positive	0.7
Optimierungsvorschlag	positive	0.7
Optimismus	positive	1
optimistisch	positive	1
Optimum	positive	1
ordentlich	positive	1
ordinär	negative	-1
ordnungsgemäß	positive	1
ordnungsliebend	positive	1
Ordnungssinn	positive	1
Ordnungswidrigkeit	negative	-0.7
Organisationsreform	positive	1
Organisationstalent	positive	0.7
orientierungslos	negative	-0.7
originalgetreu	positive	1
Originalität	positive	1
originell	positive	1
orthopädische_Krankheit	negative	-1
Osteoporose	negative	-1
osteuropäisch	negative	-0.7
packend	positive	0.7
pädophil	negative	-1
panikartig	negative	-1
Panik	negative	-1
panisch	negative	-1
Paradentose	negative	-1
paradiesisch	positive	1
Paradoxie	negative	-1
Paradox	negative	-0.7
Paradoxon	negative	-0.7
paralysieren	negative	-1
paralysiert	negative	-1
Paranoia	negative	-1
paranoid	negative	-1
Pardon	positive	0.7
Parodontose	negative	-1
Parteienstreit	negative	-0.7
Parteienverdrossenheit	negative	-1
Parteigründung	positive	0.7
Partisanenkrieg	negative	-1
partnerschaftlich	positive	1
Partnerschaft	positive	0.7
passend	positive	1
passen	negative	-0.7
Passion	positive	1
Passivität	negative	-0.7
passiv	negative	-0.7
patent	positive	0.7
pathologisch	negative	-1
pausbäckig	positive	0.7
pedantisch	negative	-0.7
peinigend	negative	-0.7
peinigen	negative	-1
peinlich	negative	-0.7
peinlich	negative	-1
Pein	negative	-1
Penalty	negative	-0.7
Penalty	negative	-1
penetrant	negative	-0.7
Penetranz	negative	-1
penibel	negative	-0.7
Pep	positive	1
Perestroika	positive	0.7
Perfektheit	positive	1
perfektionieren	positive	0.7
Perfektionierung	positive	0.7
Perfektion	positive	1
perfekt	positive	1
perfide	negative	-1
Perfidie	negative	-1
permissiv	positive	0.7
Personalabbau	negative	-0.7
persönlichkeitsgespalten	negative	-1
Persönlichkeitsspaltung	negative	-1
Persönlichkeitsstörung	negative	-1
perspektivlos	negative	-0.7
perspektivreich	positive	1
Perversion	negative	-1
Perversität	negative	-1
pervers	negative	-1
Pervertierung	negative	-1
Pessimismus	negative	-1
pessimistisch	negative	-1
Pest	negative	-1
Petersilienhochzeit	positive	0.7
petzen	negative	-1
pfeifen	negative	-1
Pfeifersches_Drüsenfieber	negative	-1
pfiffig	positive	0.7
Pfiff	positive	1
Pflanzenkrankheit	negative	-0.7
Pflegebedürftigkeit	negative	-1
pflegeleicht	positive	0.7
pflegen	positive	0.7
pfleglich	positive	0.7
pflegsam	positive	0.7
pflichtbewusst	positive	1
pflichtbewußt	positive	1
pflichteifrig	positive	0.7
pflichtgetreu	positive	0.7
Pflichtverletzung	negative	-1
phänomenal	positive	1
phantasieren	negative	-0.7
phantasievoll	positive	1
phantastisch	positive	1
Phantomschmerz	negative	-1
Philanthropie	positive	1
philanthropisch	positive	1
Phlegma	negative	-0.7
Phlegma	negative	-1
phlegmatisch	negative	-1
Phobie	negative	-1
Physiotherapie	positive	0.7
pickelig	negative	-1
piesacken	negative	-1
pietätlos	negative	-1
pikant	negative	-1
pikiert	negative	-1
pittoresk	negative	-1
Plackerei	negative	-1
plädieren	positive	0.7
plagen	negative	-1
plakativ	negative	-1
plakativ	positive	1
planlos	negative	-0.7
Planungssicherheit	positive	0.7
planvoll	positive	1
plärren	negative	-1
Platzangst	negative	-1
Platzverweis	negative	-1
Platzwunde	negative	-0.7
plausibel	positive	1
Plausibilität	positive	0.7
pleite	negative	-0.7
Pleite	negative	-1
plump	negative	-1
Plünderung	negative	-1
pöbelhaft	negative	-1
pochen	negative	-0.7
Pocken	negative	-1
Pogromnacht	negative	-0.7
Pogrom	negative	-0.7
Polemik	negative	-1
polemisch	negative	-0.7
Polizeigewalt	negative	-0.7
Pollenallergie	negative	-1
poltern	negative	-1
Polyp	negative	-1
pompös	positive	1
Pornografie	negative	-0.7
Pornographie	negative	-0.7
positiv	positive	1
possenhaft	negative	-1
possierlich	positive	0.7
Postreform	positive	1
potent	positive	0.7
potthässlich	negative	-1
potthäßlich	negative	-1
prächtig	positive	1
Pracht	positive	0.7
prachtvoll	positive	1
prädestiniert	positive	1
prädikatisieren	positive	1
präferieren	positive	1
prägen	positive	0.7
prägnant	positive	1
Prägnanz	positive	0.7
Prahlerei	negative	-1
prahlerisch	negative	-1
Praktikum	positive	1
praktisch	positive	0.7
prämieren	positive	1
präventiv	positive	0.7
praxisfremd	negative	-1
präzisieren	positive	0.7
Präzisieren	positive	0.7
Präzisierung	positive	0.7
Präzision	positive	0.7
Preisauftrieb	positive	0.7
preisen	positive	1
Preiserhöhung	positive	0.7
Preisfreigabe	positive	0.7
Preisfreigabe	positive	1
preisgeben	negative	-0.7
preisgegeben	negative	-0.7
preisgünstig	positive	1
Preisreform	positive	1
Preisstabilität	positive	0.7
preiswert	positive	1
prellen	negative	-0.7
Prellung	negative	-0.7
Pressefreiheit	positive	0.7
Pressezensur	negative	-0.7
prestigeträchtig	positive	1
preußisch	positive	1
prickelnd	positive	1
prima	positive	1
Primitivität	negative	-1
prinzipienlos	negative	-1
Prinzipientreue	positive	0.7
priorisieren	positive	0.7
privilegieren	positive	0.7
Privileg	positive	0.7
probat	positive	1
Problem	negative	-1
Produktinnovation	positive	1
Produktionssteigerung	positive	0.7
Produktivitätssteigerung	positive	0.7
produktiv	positive	0.7
profillos	negative	-0.7
Profilneurose	negative	-1
Projektbetreuung	negative	-1
Projektleitung	negative	-1
promovieren	positive	0.7
promoviert_werden	positive	0.7
Propaganda	negative	-0.7
Propaganda	positive	1
propagandistisch	negative	-0.7
Propagierung	positive	1
prophylaktisch	positive	0.7
Prophylaxe	positive	0.7
Prosperität	positive	1
Prostitution	negative	-0.7
protegieren	positive	0.7
Protzerei	negative	-1
protzig	negative	-1
Provinzialiät	negative	-0.7
Provinzialismus	negative	-0.7
provinziell	negative	-0.7
provokant	negative	-1
prüde	negative	-0.7
Prüderie	negative	-1
Prügelei	negative	-1
Prügel	negative	-0.7
prunkhaft	positive	1
Prunk	positive	0.7
prunkvoll	positive	1
Pseudokrupp	negative	-1
psychische_Störung	negative	-1
psychisch_krank	negative	-1
Psychoanalyse	positive	0.7
psychopathisch	negative	-1
Psychose	negative	-1
Psychoterror	negative	-1
Psychotherapie	positive	0.7
Publikumsgunst	positive	1
Pünktlichkeit	positive	0.7
pünktlich	positive	1
Purismus	positive	0.7
Pustel	negative	-0.7
Putsch	negative	-0.7
putzig	positive	0.7
putzmunter	positive	1
pygmäenhaft	negative	-1
quälend	negative	-1
quälen	negative	-1
Quälerei	negative	-0.7
qualifiziert	positive	1
Qualität	positive	0.7
Qualitätsmerkmal	positive	0.7
Qualitätssicherung	positive	0.7
Qualitätsverbesserung	positive	0.7
Qualitätsverlust	negative	-1
Qualitätverlust	negative	-1
Qual	negative	-1
qualvoll	negative	-1
Quarantäne	negative	-0.7
quengelig	negative	-1
quengeln	negative	-1
Querele	negative	-0.7
quer_legen	negative	-1
querlegen	negative	-1
quer_stellen	negative	-1
querstellen	negative	-1
quetschen	negative	-0.7
Quetschung	negative	-0.7
quicklebendig	positive	0.7
quietschfidel	positive	1
quietschvergnügt	positive	1
quirlig	positive	0.7
quittieren	positive	0.7
Rabatz	negative	-1
rabiat	negative	-0.7
Racheakt	negative	-1
Rache	negative	-1
rächen	negative	-1
Rachgier	negative	-1
rachsüchtig	negative	-1
Rachsucht	negative	-1
rackern	negative	-0.7
Radau	negative	-1
Radikalisierung	negative	-1
Radikalkur	positive	0.7
Raffgier	negative	-1
Raffinement	positive	1
raffiniert	negative	-1
Rage	negative	-1
Raketenangriff	negative	-1
ramponiert	negative	-0.7
Randale	negative	-1
Rangelei	negative	-0.7
Ränke	negative	-0.7
Ränkespiel	negative	-1
rappeldürr	negative	-0.7
Rappel	negative	-1
Rarität	positive	0.7
Raserei	negative	-1
Rassenressentiment	negative	-1
Rassentrennung	negative	-1
Rassenunruhen	negative	-0.7
rassig	positive	1
rassistisch	negative	-1
Rastlosigkeit	negative	-1
rastlos	negative	-0.7
Ratifizierung	positive	1
Rationalisierung	negative	-0.7
rational	positive	1
Ratlosigkeit	negative	-1
ratlos	negative	-0.7
ratlos	negative	-1
Rat	positive	1
ratsam	positive	1
räuberisch	negative	-1
Raubmord	negative	-0.7
Raub	negative	-1
Raubüberfall	negative	-0.7
Raucherbein	negative	-1
Rauchvergiftung	negative	-1
Rauferei	negative	-1
rauh	negative	-0.7
Raum	positive	0.7
rau	negative	-0.7
rauschfrei	negative	-1
Rauschgiftkriminalität	negative	-1
rausekeln	negative	-1
rausfeuern	negative	-0.7
rauskotzen	negative	-0.7
rauslassen	negative	-1
rauspfeffern	negative	-0.7
rausschmeißen	negative	-0.7
rausschmeißen	negative	-1
rausspucken	negative	-0.7
rauswerfen	negative	-0.7
rauswerfen	negative	-1
Razzia	negative	-0.7
reaktionsschnell	positive	1
Reaktorsicherheit	positive	0.7
realistisch	positive	1
Realitätssinn	positive	1
real	positive	1
Rebellion	negative	-0.7
rebellisch	negative	-0.7
Rechtfertigung	positive	0.7
Rechtlosigkeit	negative	-0.7
Rechtmäßigkeit	positive	0.7
rechtmäßig	positive	1
recht	positive	1
Rechtsbeugung	negative	-0.7
Rechtsbruch	negative	-0.7
Rechtschaffenheit	positive	1
rechtschaffen	positive	0.7
Rechtsempfinden	positive	1
rechtsextremistisch	negative	-1
rechtsextrem	negative	-1
Rechtsfrieden	positive	0.7
Rechtsgefühl	positive	1
Rechtshilfe	positive	0.7
rechtslastig	negative	-1
rechtsradikal	negative	-1
Rechtsruck	negative	-1
Rechtssicherheit	positive	0.7
Rechtsunsicherheit	negative	-0.7
reckenhaft	negative	-0.7
redebegabt	positive	1
redegewandt	positive	1
Redlichkeit	positive	1
redlich	positive	0.7
reduktionistisch	negative	-1
Reduktionskur	positive	0.7
Redundanz	negative	-0.7
reell	positive	1
reflektieren	positive	0.7
Reflexhandlung	negative	-1
Reflex	negative	-0.7
Reformation	positive	0.7
reformieren	positive	0.7
Reformierung	positive	1
Reform	positive	1
Reformprogramm	positive	0.7
Regeneration	positive	0.7
regenerativ	positive	0.7
regenerieren	positive	0.7
rege	positive	0.7
Regierungsgewalt	negative	-0.7
regierungstreu	positive	0.7
regulär	positive	1
Regungslosigkeit	negative	-1
Rehabilitationsprogramm	positive	0.7
rehabilitieren	positive	1
Rehabilitierungskur	positive	0.7
Reha-Kur	positive	0.7
Reibereien	negative	-0.7
reichhaltig	positive	0.7
reichhaltig	positive	1
reichlich	positive	1
reich	positive	0.7
reich	positive	1
Reichsgründung	positive	0.7
Reife	positive	1
reif	positive	0.7
reihern	negative	-0.7
Reinhaltung	positive	0.7
reinigen	positive	0.7
Reinlichkeit	positive	1
reinlich	positive	0.7
rein	positive	1
Reinverlust	negative	-1
Reisefieber	negative	-1
Reiselust	positive	1
Reisethrombose	negative	-1
reißerisch	negative	-0.7
Reizbarkeit	negative	-1
reizend	positive	1
reizlos	negative	-0.7
reizlos	negative	-1
Reiz	positive	0.7
reizvoll	positive	1
Reizwort	negative	-0.7
reklamieren	negative	-1
Rekonvaleszenz	positive	0.7
Rekordhöhe	positive	0.7
relaxed	positive	0.7
relaxen	positive	0.7
Religionskrieg	negative	-1
renitent	negative	-0.7
renommiert	positive	1
Renovierung	positive	0.7
Rentenanspruch	positive	0.7
Rentenreform	positive	1
Reparatur	positive	1
Repressalie	negative	-0.7
Repressalie	negative	-1
Repression	negative	-1
repressionsfrei	positive	1
repressiv	negative	-1
reputierlich	positive	0.7
reserviert	negative	-0.7
resignieren	negative	-0.7
resignieren	negative	-1
resigniert	negative	-1
resistent	positive	1
Resistenz	positive	0.7
respektieren	positive	1
respektlos	negative	-1
Respekt	positive	1
respektvoll	positive	1
Ressentiment	negative	-1
Restauration	positive	0.7
Restaurierung	positive	0.7
Restitution	positive	0.7
retardiert	negative	-0.7
Retourkutsche	negative	-1
Rettung	positive	0.7
Rettung	positive	1
Rettungsaktion	positive	0.7
Rettungsaktion	positive	1
Rettungsanker	positive	0.7
Reue	negative	-1
reuen	negative	-1
Revanche	negative	-1
revanchieren	negative	-0.7
revidieren	positive	0.7
Revitalisierung	positive	0.7
Revolte	negative	-0.7
Revolution	negative	-0.7
Rheuma	negative	-1
Richtigkeit	positive	1
richtig	positive	1
richtig_stellen	positive	0.7
richtigstellen	positive	0.7
richtungslos	negative	-0.7
rigide	negative	-1
rigid	negative	-1
rigoros	negative	-1
Rinderseuche	negative	-0.7
Rinderwahnsinn	negative	-0.7
Rippenbruch	negative	-1
Rippenfellentzündung	negative	-1
Risikofaktor	negative	-0.7
risikofrei	positive	0.7
risikolos	positive	0.7
Rivalität	negative	-1
Robustheit	positive	0.7
robust	positive	0.7
Rodung	negative	-1
roh	negative	-0.7
rollstuhlgerecht	positive	1
Rosenhochzeit	positive	0.7
Rosskur	positive	0.7
rostfrei	positive	0.7
Röteln	negative	-1
Rotsperre	negative	-1
routiniert	positive	1
ruchbar	negative	-1
ruchlos	negative	-1
Rückenmassage	positive	0.7
Rückenschmerz	negative	-1
Rückenschule	positive	0.7
Rückeroberung	negative	-0.7
rückfällig	negative	-0.7
Rückfall	negative	-1
Rückgangsquote	negative	-0.7
Rückgangsrate	negative	-0.7
Rückgrat	positive	0.7
Rücksichtslosigkeit	negative	-1
rücksichtslos	negative	-1
rücksichtsvoll	positive	1
Rückständigkeit	negative	-1
rückstandsfrei	positive	0.7
rüde	negative	-0.7
Rüffel	negative	-1
rüffeln	negative	-1
Ruf	negative	-0.7
Rüge	negative	-1
rügen	negative	-1
Ruhelosigkeit	negative	-1
ruhelos	negative	-0.7
Ruhe	positive	0.7
Ruhestörung	negative	-0.7
ruhig	positive	0.7
rühmen	positive	1
rühmlich	positive	0.7
ruhmlos	negative	-0.7
ruhmreich	positive	1
ruhmvoll	positive	1
rührend	positive	0.7
rühren	positive	0.7
rührig	positive	0.7
rührselig	negative	-1
Rührung	positive	1
ruinieren	negative	-1
ruiniert	negative	-0.7
Ruin	negative	-1
rumlügen	negative	-1
rumzetern	negative	-1
Runderneuerung	positive	0.7
runtermachen	negative	-1
runterputzen	negative	-1
rüpelhaft	negative	-0.7
ruppig	negative	-0.7
rüstig	positive	1
Rüstung	negative	-1
Rüstungsgeschäft	negative	-0.7
Rüstungswettlauf	negative	-1
Sabotage	negative	-0.7
sabotieren	negative	-0.7
Sachbeschädigung	negative	-0.7
sachbezogen	positive	0.7
sachgemäß	positive	1
sachgerecht	positive	1
sachkundig	positive	1
sachlich	positive	1
sachte	positive	0.7
sacht	positive	0.7
Sachzwang	negative	-0.7
Sadismus	negative	-1
sadistisch	negative	-1
sagenumrankt	positive	1
sagenumwoben	positive	1
Sakrileg	negative	-0.7
Salmonellenvergiftung	negative	-1
Salve	negative	-1
Sanftmut	positive	1
sanft	positive	1
Sanierung	positive	0.7
Sanierung	positive	1
sanktionieren	negative	-0.7
Sanktionierung	negative	-1
Sanktion	negative	-1
sarkastisch	negative	-0.7
satanisch	negative	-1
satt	positive	0.7
satt	positive	1
saublöd	negative	-1
saudoof	negative	-1
saudumm	negative	-1
Sauerei	negative	-1
sauer	negative	-0.7
Säuglingssterberate	negative	-1
Säuglingssterblichkeit	negative	-1
saukomisch	positive	1
säumig	negative	-1
schäbig	negative	-1
Schädelbruch	negative	-1
schade	negative	-1
schadenfrei	positive	0.7
Schadenfreude	negative	-1
schadenfroh	negative	-1
schaden	negative	-1
Schadensbegrenzung	positive	0.7
Schadensbegrenzungsmaßnahme	positive	0.7
Schadenseindämmung	positive	0.7
schadensfrei	positive	1
Schadensursache	negative	-0.7
schädigen	negative	-1
schadstofffrei	positive	0.7
Schaffenskraft	positive	1
Schaffung	positive	0.7
schal	negative	-1
schämen	negative	-1
Schamgefühl	negative	-1
schamhaft	negative	-0.7
schamlos	negative	-1
Scham	negative	-1
Schande	negative	-1
schänden	negative	-1
schändlich	negative	-1
Schandtat	negative	-0.7
scharfsinnig	positive	1
Scharlach	negative	-1
scharmant	positive	1
Scharm	positive	0.7
Scharmützel	negative	-0.7
schassen	negative	-0.7
schätzen	positive	1
Schatz	positive	0.7
schauderhaft	negative	-1
Schauder	negative	-1
schaudern	negative	-1
schaudervoll	negative	-1
schauerhaft	negative	-1
schauerlich	negative	-1
Schauer	negative	-1
schäumen	negative	-1
schaurig	negative	-1
Schauspiel	positive	0.7
Scheidenpilz	negative	-0.7
scheinheilig	negative	-1
Scheißdreck	negative	-1
scheiß	negative	-1
Schelte	negative	-1
schelten	negative	-1
scherzen	positive	0.7
scherzhaft	positive	1
scheuen	negative	-1
scheu	negative	-0.7
Scheu	negative	-1
Scheußlichkeit	negative	-0.7
scheußlich	negative	-1
schicker	negative	-0.7
Schiebung	negative	-0.7
Schiebung	negative	-1
schiefgegangen	negative	-1
schiefgelaufen	negative	-1
schief_liegen	negative	-0.7
schiefliegen	negative	-0.7
Schießen	negative	-1
Schießerei	negative	-0.7
Schiffbruch	negative	-1
Schiffssicherheit	positive	0.7
Schikane	negative	-1
schikanieren	negative	-1
schimpfen	negative	-1
Schimpf	negative	-1
schinden	negative	-1
Schinderei	negative	-1
Schiss	negative	-1
schizoid	negative	-1
Schizophrenie	negative	-1
schizophren	negative	-1
Schlachtung	negative	-0.7
Schlaffheit	negative	-0.7
schlaff	negative	-0.7
Schlaflosigkeit	negative	-1
Schläfrigkeit	negative	-0.7
schläfrig	positive	1
Schlaganfall	negative	-1
Schläge	negative	-0.7
Schlägerei	negative	-1
schlagfertig	positive	0.7
schlagkräftig	positive	1
Schlagkraft	positive	0.7
Schlamperei	negative	-0.7
Schlampigkeit	negative	-1
schlampig	negative	-1
Schlangenbiss	negative	-1
Schlangenbiß	negative	-1
Schlappheit	negative	-0.7
schlapp	negative	-0.7
schlau	positive	1
schlechter_stellen	negative	-0.7
schlechtes_Gewissen	negative	-1
schlecht_gelaunt	negative	-1
schlechtgelaunt	negative	-1
Schlechtigkeit	negative	-1
schlechtmachen	negative	-1
schlecht	negative	-1
schlechtreden	negative	-1
schleifen	negative	-1
Schleimbeutelentzündung	negative	-1
Schleimhautgeschwulst	negative	-1
Schleudertrauma	negative	-1
schlicht	positive	0.7
Schlichtung	positive	0.7
schlimm	negative	-1
schluchzen	negative	-1
Schluckauf	negative	-1
Schluckbeschwerden	negative	-1
Schludrigkeit	negative	-1
Schlüsselbeinbruch	negative	-1
Schlüsselposition	positive	0.7
Schlüsselstellung	positive	0.7
schlüssig	positive	1
Schmach	negative	-1
schmachvoll	negative	-1
schmähen	negative	-1
schmählich	negative	-1
Schmähung	negative	-1
Schmälerung	negative	-0.7
schmarotzen	negative	-0.7
schmarotzern	negative	-0.7
Schmeichelei	positive	1
schmeichelhaft	negative	-1
schmeicheln	positive	1
schmeißen	negative	-0.7
Schmerzattacke	negative	-1
schmerzen	negative	-1
schmerzfrei	positive	1
schmerzhaft	negative	-1
schmerzlich	negative	-1
schmerzlos	negative	-0.7
Schmerz	negative	-1
schmerzvoll	negative	-1
Schmiergeldzahlung	negative	-0.7
Schmiergeldzahlung	negative	-1
schmollen	negative	-1
schmuck	positive	0.7
schmuddelig	negative	-1
Schmuggel	negative	-0.7
Schmu	negative	-0.7
Schmu	negative	-1
schmunzeln	positive	1
schneidend	negative	-1
Schneid	positive	1
schnell	positive	0.7
Schnittstellenoptimierung	positive	0.7
schnöde	negative	-0.7
schnöde	negative	-1
schnörkellos	positive	0.7
schnüffeln	negative	-1
Schnupfen	negative	-1
schocken	negative	-1
schockierend	negative	-1
schockieren	negative	-1
Schockiertheit	negative	-1
schockiert	negative	-1
Schock	negative	-1
Schocktherapie	positive	0.7
schonend	positive	0.7
schonen	positive	0.7
Schönheit	positive	1
Schönheitsfehler	negative	-0.7
Schönheitssinn	positive	1
schön	positive	1
schönreden	negative	-1
Schonungslosigkeit	negative	-1
schonungslos	negative	-0.7
schöpferisch	positive	1
Schorf	negative	-0.7
Schramme	negative	-0.7
schrankenlos	positive	0.7
schreckenerregend	negative	-1
Schrecken_erregend	negative	-1
schrecken	negative	-1
Schrecken	negative	-1
Schreckensherrschaft	negative	-1
schreckhaft	negative	-1
schrecklich	negative	-1
Schreck	negative	-1
Schreien	negative	-0.7
schreien	negative	-1
Schreikrampf	negative	-1
Schrei	negative	-0.7
schroff	negative	-0.7
Schrulligkeit	negative	-0.7
Schüchternheit	negative	-1
schüchtern	negative	-0.7
schuften	negative	-0.7
Schufterei	negative	-1
Schulausbildung	positive	1
schuldenfrei	positive	0.7
Schuldenlast	negative	-0.7
Schulden	negative	-0.7
Schuldgefühl	negative	-1
schuldig	negative	-1
Schuld	negative	-1
schulmeistern	negative	-1
Schulreform	positive	1
Schulverweis	negative	-1
Schummelei	negative	-0.7
Schummelei	negative	-1
Schummel	negative	-0.7
Schummel	negative	-1
schummeln	negative	-0.7
Schund	negative	-1
Schuppenflechte	negative	-0.7
Schürfwunde	negative	-0.7
schurigeln	negative	-1
Schuss	negative	-1
Schuß	negative	-1
Schusswechsel	negative	-0.7
Schußwechsel	negative	-0.7
Schusswunde	negative	-0.7
Schußwunde	negative	-0.7
schützend	positive	1
schützen	positive	0.7
schutzlos	negative	-0.7
Schwächeanfall	negative	-1
Schwäche	negative	-0.7
Schwächen	negative	-0.7
Schwächen	negative	-1
Schwäche	positive	0.7
schwach	negative	-0.7
schwachsinnig	negative	-1
Schwächung	negative	-0.7
Schwächung	negative	-1
Schwangerschaftsbeschwerden	negative	-1
schwankend	negative	-0.7
schwänzen	negative	-0.7
schwanzgesteuert	negative	-0.7
schwärmen	positive	0.7
schwärmen	positive	1
schwärmerisch	positive	1
schwarz_arbeiten	negative	-0.7
schwarzarbeiten	negative	-0.7
schwarz_malen	negative	-0.7
schwarzmalen	negative	-0.7
Schwarzmalerei	negative	-1
schwarz	negative	-0.7
schwarz	positive	0.7
schwarz_sehen	negative	-0.7
schwarzsehen	negative	-0.7
Schweinegrippe	negative	-1
Schweinerei	negative	-1
Schwellenangst	negative	-1
Schwellung	negative	-0.7
schwergewichtig	negative	-0.7
Schwerhörigkeit	negative	-1
schwermütig	negative	-1
Schwermut	negative	-1
schwerreich	positive	0.7
Schwerstarbeit	negative	-1
schwerverletzt	negative	-1
schwerverwundet	negative	-1
Schwesterlichkeit	positive	1
schwierig	negative	-0.7
schwindelerregend	positive	1
Schwindel	negative	-0.7
Schwindel	negative	-1
schwindeln	negative	-1
schwindlig	negative	-1
Schwindsucht	negative	-1
schwören	positive	1
Schwung	positive	0.7
Seelenfrieden	positive	1
Seelenheil	positive	0.7
Seelenlosigkeit	negative	-1
seelenlos	negative	-1
Seelenregung	positive	1
seelenruhig	negative	-1
Seelenverwandtschaft	positive	0.7
Seelenverwandtschaft	positive	1
seelenvoll	positive	1
seelig	positive	1
seelisch_behindert	negative	-1
Segen	positive	0.7
Sehbehinderung	negative	-0.7
sehenswert	positive	0.7
Sehenswürdigkeit	positive	0.7
sehenswürdig	positive	0.7
sehnen	positive	0.7
Sehnenscheidenentzündung	negative	-1
Seitenhieb	negative	-0.7
Seitenstiche	negative	-1
Selbständigkeit	positive	0.7
selbständig	positive	0.7
Selbstbeherrschung	positive	0.7
Selbstbestimmung	positive	1
Selbstbestimmungsrecht	positive	0.7
Selbstbetrug	negative	-0.7
Selbstbetrug	negative	-1
Selbstbeweihräucherung	positive	1
selbstbewusst	positive	1
selbstbewußt	positive	1
Selbstdisziplin	positive	0.7
Selbstentblößung	negative	-1
Selbsterhaltung	positive	0.7
selbstgefällig	negative	-1
selbstgerecht	negative	-1
selbstherrlich	negative	-1
Selbstjustiz	negative	-1
selbstkritisch	positive	1
Selbstlob	positive	1
Selbstlosigkeit	positive	1
selbstlos	positive	1
Selbstmitleid	negative	-1
Selbstmordanschlag	negative	-0.7
Selbstmordattentat	negative	-0.7
selbstmordgefährdet	negative	-0.7
Selbstmord	negative	-0.7
selbstschädigend	negative	-1
selbstsicher	positive	1
selbstständig	positive	0.7
selbstsüchtig	negative	-1
Selbsttäuschung	negative	-0.7
Selbsttäuschung	negative	-1
Selbsttötung	negative	-0.7
Selbstverständlichkeit	negative	-1
Selbstverteidigung	positive	0.7
Selbstverteidigungssport	positive	0.7
Selbstverteidigungstechnik	positive	0.7
Selbstvertrauen	positive	1
selbstzerstörerisch	negative	-1
Seligkeit	positive	1
selig	positive	0.7
seltsam	negative	-0.7
seltsam	negative	-1
Senge	negative	-0.7
sensationell	positive	1
sensationsheischend	negative	-0.7
sensibilisieren	positive	1
Sensibilität	positive	0.7
sensitivieren	positive	0.7
Sentimentalität	negative	-1
sentimental	negative	-1
seriös	positive	0.7
servil	negative	-0.7
Seuche	negative	-1
seufzen	negative	-0.7
sexgierig	negative	-0.7
sexhungrig	negative	-0.7
Sexsucht	negative	-1
Sexualdelikt	negative	-0.7
sexuelle_Belästigung	negative	-0.7
sexueller_Missbrauch	negative	-0.7
sexueller_Mißbrauch	negative	-0.7
Sicherheit	positive	1
sichern	positive	0.7
sicher	positive	0.7
sicher	positive	1
Sicherung	positive	0.7
Sich-sicher-Fühlen	positive	1
Sich-wohl-Fühlen	positive	1
Siebenmeter	negative	-0.7
Siebenmeter	negative	-1
Siechtum	negative	-1
siegesbewusst	positive	0.7
siegesbewußt	positive	0.7
siegesgewiss	positive	0.7
siegesgewiß	positive	0.7
siegessicher	positive	0.7
siegreich	positive	1
Silberhochzeit	positive	0.7
Silberne_Hochzeit	positive	0.7
simulieren	negative	-0.7
sinnentleert	negative	-0.7
sinnfrei	negative	-1
sinnig	positive	1
sinnleer	negative	-0.7
sinnlich	positive	1
Sinnlosigkeit	negative	-1
sinnlos	negative	-1
Sinnverwirrung	negative	-1
sinnvoll	positive	1
Sisyphusarbeit	negative	-1
sittenlos	negative	-1
Sittlichkeitsverbrechen	negative	-0.7
sittlich	positive	1
sittsam	positive	1
sitzen_bleiben	negative	-0.7
sitzenbleiben	negative	-0.7
Sitzstreik	negative	-0.7
skandalös	negative	-1
skandalträchtig	negative	-1
skandalumrankt	negative	-1
skandalumwoben	negative	-1
Sklavenarbeit	negative	-1
Sklavenaufstand	negative	-0.7
Sklaverei	negative	-1
Sklerose	negative	-1
Skorpionstich	negative	-1
Skrupellosigkeit	negative	-1
skrupellos	negative	-1
skurril	negative	-1
smart	positive	0.7
snobbistisch	negative	-0.7
Sodbrennen	negative	-0.7
solidarisieren	positive	0.7
Solidarität	positive	1
Solidaritätsaktion	positive	0.7
solide	positive	0.7
sommerlich	positive	0.7
sommerlich-sonnig	positive	0.7
sonderbar	negative	-1
sonderlich	negative	-1
Sonderstellung	positive	0.7
sonnambul	negative	-1
Sonnenallergie	negative	-1
Sonnenbrand	negative	-0.7
sonnen	positive	1
sonnig	positive	0.7
Sorge	negative	-1
sorgenfrei	positive	1
sorgen	negative	-1
sorgen	positive	0.7
sorgenvoll	negative	-1
sorgfältig	positive	0.7
Sorglosigkeit	negative	-0.7
sorglos	positive	1
sorgsam	positive	0.7
souverän	positive	0.7
souverän	positive	1
Sozialabbau	negative	-0.7
Sozialbetreuung	negative	-1
sozial	positive	0.7
Spamming	negative	-0.7
Spamming	negative	-1
spannend	positive	0.7
Spannung	positive	1
Spannungskopfschmerz	negative	-1
Spannungskopfweh	negative	-1
sparsam	positive	0.7
spaßen	positive	0.7
spaßhaft	positive	0.7
spaßhaft	positive	1
spaßig	positive	0.7
spaßig	positive	1
Spaß	positive	1
spätsommerlich	positive	0.7
Speicherung	positive	0.7
speien	negative	-0.7
Spektakel	positive	0.7
spektakulär	positive	0.7
spektakulär	positive	1
Spendenaktion	positive	0.7
sperren	negative	-1
Spielfreude	positive	1
Spiellust	positive	1
Spielraum	positive	0.7
Spielsucht	negative	-1
Spielwitz	positive	1
spießerhaft	negative	-0.7
spießerisch	negative	-0.7
spießig	negative	-0.7
Spießrutenlaufen	negative	-1
Spießrutenlauf	negative	-1
spindeldürr	negative	-0.7
spinnen	negative	-0.7
Spinnenphobie	negative	-1
spintisieren	negative	-0.7
Spionage	negative	-0.7
spionieren	negative	-1
spitze	positive	1
spitzfindig	negative	-0.7
spitz	negative	-0.7
Spleen	negative	-0.7
sponsern	positive	0.7
Spontaneität	positive	0.7
sportbegabt	positive	1
sportbegeistert	positive	1
sportinteressiert	positive	1
sportiv	positive	0.7
Sportlichkeit	positive	0.7
sportlich	positive	0.7
sportlich	positive	1
spotten	negative	-1
spöttisch	negative	-0.7
Spott	negative	-1
sprachbegabt	positive	1
Sprachbehinderung	negative	-1
Sprachlosigkeit	negative	-1
sprachlos	negative	-0.7
Sprechstörung	negative	-1
Sprengstoffanschlag	negative	-0.7
Sprengstoffattentat	negative	-0.7
Sprengung	negative	-1
Sprengzündung	negative	-1
spröde	negative	-0.7
sprunghaft	negative	-0.7
spucken	negative	-0.7
spukhaft	negative	-1
Spurensicherung	positive	0.7
staatsfeindlich	negative	-1
staatskonform	positive	1
staatsmännisch	positive	0.7
Staatssicherheit	positive	0.7
Staatsstreich	negative	-0.7
Stabilisieren	positive	1
Stabilisierung	positive	1
Stabilität	positive	0.7
standardisieren	positive	0.7
standesgemäß	positive	1
Standfestigkeit	positive	0.7
Standfestigkeit	positive	1
Standhaftigkeit	positive	1
standhaft	positive	1
standhalten	positive	0.7
Standpauke	negative	-1
stänkern	negative	-1
stark	positive	0.7
stark	positive	1
starrköpfig	negative	-1
starr	negative	-1
Starrsinn	negative	-1
Starterlaubnis	positive	0.7
Startschuss	negative	-1
Startschuß	negative	-1
statisch	negative	-0.7
statthaft	positive	1
stattlich	positive	1
Stauballergie	negative	-1
Staunen	negative	-0.7
staunen	positive	1
stechen	negative	-0.7
Stehvermögen	positive	0.7
steif	negative	-0.7
Steigerung	positive	0.7
steinreich	positive	0.7
Stellungskrieg	negative	-1
sterbenslangweilig	negative	-1
Sterblichkeit	negative	-0.7
Sterblichkeitsrate	negative	-1
Sterilität	negative	-0.7
Steuerbetrug	negative	-0.7
Steuerbetrug	negative	-1
Steuerdelikt	negative	-0.7
Steuereinnahmen	positive	0.7
Steuererhöhung	positive	0.7
Steuerhinterziehung	negative	-0.7
steuern	negative	-0.7
Steuerreform	positive	1
Steuerschuld	negative	-0.7
sticheln	negative	-1
stichhaltig	positive	1
Stich	negative	-0.7
Stichwunde	negative	-0.7
stiefmütterlich	negative	-0.7
Stierhunger	negative	-1
stigmatisieren	negative	-1
Stilbruch	negative	-1
stilecht	positive	1
stillschweigend	negative	-0.7
stilvoll	positive	1
stimmig	positive	1
stimmrechtslos	negative	-0.7
stimmungsvoll	positive	1
stimulierend	negative	-0.7
stinken	negative	-0.7
stinklangweilig	negative	-1
stinkreich	positive	0.7
stocksteif	negative	-1
Stoffwechselstörung	negative	-1
stöhnen	negative	-0.7
Stöhnen	negative	-0.7
stöhnen	negative	-1
stolz	positive	0.7
Stolz	positive	1
stoned	negative	-0.7
störend	negative	-1
Störfaktor	negative	-1
störrisch	negative	-1
Störung	negative	-1
störungsfrei	positive	0.7
störungslos	positive	0.7
Störungsursache	negative	-0.7
strafbar	negative	-1
Strafe	negative	-1
strafen	negative	-1
straffällig	negative	-1
sträflich	negative	-0.7
Strafmaßnahme	negative	-0.7
Strafmaßnahme	negative	-1
strafmildernd	positive	1
Strafpredigt	negative	-1
Strafsache	negative	-0.7
strafsenkend	positive	1
Strafstoß	negative	-0.7
Strafstoß	negative	-1
Straftat	negative	-0.7
Strafvollzug	negative	-1
strahlend	positive	0.7
strahlend	positive	1
Strahlentherapie	positive	0.7
strähnig	negative	-0.7
stramm	negative	-0.7
strapazieren	negative	-0.7
strapazieren	negative	-1
Straßenkampf	negative	-0.7
Straßenschlacht	negative	-0.7
Straßentumult	negative	-0.7
Straßenverkehrsdelikt	negative	-0.7
sträuben	negative	-1
strebsam	positive	0.7
Streik	negative	-0.7
streitig	negative	-1
Streit	negative	-1
streitsüchtig	negative	-1
streng	negative	-0.7
stressen	negative	-0.7
stressen	negative	-1
stressfrei	positive	1
streuen	negative	-1
strikt	negative	-0.7
stringent	positive	1
strittig	negative	-1
strohdoof	negative	-1
strohdumm	negative	-1
Studienreise	positive	0.7
studiert	positive	0.7
Studium	positive	1
stumm	negative	-0.7
stumm	negative	-1
Stümperhaftigkeit	negative	-1
stümperhaft	negative	-1
Stümpertum	negative	-1
Stumpfheit	negative	-1
stumpfsinnig	negative	-1
Stumpfsinn	negative	-1
Stunk	negative	-1
Stupidität	negative	-1
Sturmangriff	negative	-1
stur	negative	-1
stürzen	negative	-1
sublimieren	positive	1
subsidiär	positive	1
subtil	positive	1
suchtgefährdet	negative	-0.7
Sucht	negative	-1
Suchtverhalten	negative	-1
süffisant	positive	0.7
Suff	negative	-1
suggerieren	negative	-0.7
sühnen	negative	-1
Sühne	positive	0.7
suizidgefährdet	negative	-0.7
Suizid	negative	-0.7
Sünde	negative	-0.7
Sündenerlass	positive	0.7
Sündenerlaß	positive	0.7
Sündennachlass	positive	0.7
Sündennachlaß	positive	0.7
sündhaft	negative	-1
sündig	negative	-1
super	positive	1
Superstimmung	positive	1
suspekt	negative	-1
suspendieren	negative	-0.7
Süße	positive	0.7
süß	positive	0.7
sympathieerweckend	positive	1
Sympathie_erweckend	positive	1
Sympathie	positive	1
sympathisch	positive	1
sympathisieren	positive	1
Syphilis	negative	-1
systematisch	positive	1
Systembetreuung	negative	-1
Tabellenabstieg	negative	-1
Tabellenaufstieg	positive	0.7
Tablettenabhängigkeit	negative	-1
Tablettenmissbrauch	negative	-1
Tablettenmißbrauch	negative	-1
Tablettensucht	negative	-1
tabufrei	positive	0.7
tabuieren	negative	-0.7
tabuisieren	negative	-0.7
tabulos	positive	0.7
Tadel	negative	-1
tadeln	negative	-1
tadelnswert	negative	-0.7
Taktgefühl	positive	1
taktieren	negative	-0.7
taktlos	negative	-0.7
taktlos	negative	-1
Takt	positive	1
taktvoll	positive	1
talentiert	positive	1
Talent	positive	1
Talentschmiede	positive	0.7
Tamtam	positive	0.7
tapfer	positive	1
Tarnung	negative	-0.7
Tarnung	negative	-1
Tatendrang	positive	1
Tatendurst	positive	1
Tatenlosigkeit	negative	-1
tatenlos	negative	-1
Tatenlust	positive	1
tatkräftig	positive	0.7
Tatkraft	positive	1
tätlich	negative	-1
Tat	negative	-0.7
Taubheit	negative	-1
taub	negative	-1
taub_werden	negative	-1
Tauglichkeit	positive	1
tauglich	positive	0.7
täuschend	negative	-1
täuschen	negative	-0.7
täuschen	negative	-1
Täuschung	negative	-0.7
Täuschung	negative	-1
Täuschungsmanöver	negative	-0.7
TBC	negative	-1
Teamfähigkeit	positive	1
Teamgeist	positive	1
Technologiefeindlichkeit	negative	-1
Technologiefreundlichkeit	positive	1
Teilnahme	positive	1
Teilnahmslosigkeit	negative	-1
teilnahmslos	negative	-0.7
temperamentvoll	positive	0.7
tendenziös	negative	-1
Territorialverteidigung	positive	0.7
Terrorakt	negative	-0.7
Terroranschlag	negative	-0.7
terrorisieren	negative	-1
Terrorismus	negative	-0.7
terroristisch	negative	-0.7
Terror	negative	-1
testieren	positive	0.7
Tetanus	negative	-1
teuer	negative	-1
Teuerung	positive	0.7
Teufelswerk	negative	-1
teuflisch	negative	-1
theaterbegeistert	positive	1
Theatergenuss	positive	1
Theatergenuß	positive	1
theaterinteressiert	positive	1
Theatralik	negative	-0.7
theatralisch	negative	-0.7
Therapie	positive	0.7
Thrombose	negative	-1
Thronraub	negative	-0.7
Tick	negative	-0.7
tief_bewegt	positive	1
tiefbewegt	positive	1
Tiefenanalyse	positive	0.7
tiefgehend	positive	1
tiefgreifend	positive	1
tiefgründig	positive	1
Tief	negative	-1
tiefschürfend	positive	1
tiefsinnig	positive	1
tiefstapeln	negative	-1
tief_traurig	negative	-1
tieftraurig	negative	-1
Tierfeindlichkeit	negative	-1
Tierfreundlichkeit	positive	1
Tierkrankheit	negative	-0.7
Tierliebe	positive	1
Tierquälerei	negative	-0.7
Tierseuche	negative	-0.7
Titelverteidigung	positive	0.7
toben	negative	-1
Todesangst	negative	-1
Todeskampf	negative	-0.7
todesmutig	positive	0.7
Todesrate	negative	-1
Todessehensucht	negative	-1
Todesstrafe	negative	-0.7
Todesstrafe	negative	-1
todmüde	negative	-1
Todsünde	negative	-0.7
todtraurig	negative	-1
todunglücklich	negative	-1
tolerant	positive	1
tolerieren	positive	0.7
tolerieren	positive	1
tolldreist	negative	-0.7
tollkühn	positive	0.7
toll	positive	1
Tollwut	negative	-1
tolpatschig	negative	-1
tölpelhaft	negative	-1
tölpisch	negative	-1
tonangebend	negative	-1
tonangebend	positive	0.7
Topform	positive	0.7
top	positive	1
töricht	negative	-1
Tortur	negative	-1
totalitär	negative	-1
töten	negative	-1
tot	negative	-1
Totschlag	negative	-0.7
totschweigen	negative	-0.7
Tötung	negative	-0.7
Tötungsdelikt	negative	-0.7
Touristenattraktion	positive	0.7
traditionsreich	positive	1
tragbar	positive	1
träge	negative	-0.7
tragfähig	positive	1
Trägheit	negative	-0.7
tragikomisch	positive	1
tragisch	negative	-1
träg	negative	-0.7
trainiert	positive	0.7
traktieren	negative	-1
trampelhaft	negative	-1
tränen	negative	-0.7
tranig	negative	-1
Transparenz	positive	0.7
transusig	negative	-1
tratschen	negative	-0.7
tratschsüchtig	negative	-0.7
trauen	positive	0.7
Trauer	negative	-1
trauern	negative	-1
Trauerstimmung	negative	-1
Trauma	negative	-1
Traumatherapie	positive	0.7
traumatisch	negative	-1
traumatisierend	negative	-1
traumatisieren	negative	-1
traumhaft	positive	1
Traumreise	positive	0.7
Traurigkeit	negative	-1
traurig	negative	-1
Trauung	positive	0.7
treuelos	negative	-1
Treue	positive	1
treuherzig	negative	-0.7
Treulosigkeit	negative	-1
treulos	negative	-1
treu	positive	1
tricksen	negative	-0.7
triebhaft	negative	-1
triezen	negative	-1
Trinksucht	negative	-1
Tripper	negative	-1
Tristesse	negative	-1
trist	negative	-1
triumphieren	positive	1
Triumph	positive	1
trocken	negative	-0.7
Trommelfeuer	negative	-1
tröstend	positive	1
trösten	positive	1
tröstlich	positive	1
Trostlosigkeit	negative	-1
trostlos	negative	-1
Trost	positive	0.7
Trost	positive	1
trostspendend	positive	1
Trostspende	positive	0.7
trottelhaft	negative	-1
trottelig	negative	-1
trotzig	negative	-0.7
Trotz	negative	-1
Trotzreaktion	negative	-0.7
trüb	negative	-0.7
Trübsal	negative	-1
Trübseligkeit	negative	-1
trübselig	negative	-1
Trübsinnigkeit	negative	-1
trübsinnig	negative	-1
Trübsinn	negative	-1
trügerisch	negative	-1
Trug	negative	-0.7
Trug	negative	-1
Trunkenheit	negative	-1
trunken	negative	-1
Trunksucht	negative	-1
Truppenabbau	negative	-0.7
Truppenbetreuung	negative	-1
Truppenreduzierung	negative	-0.7
tuberkular	negative	-1
Tuberkulose	negative	-1
Tüchtigkeit	positive	0.7
tüchtig	positive	0.7
Tücke	negative	-1
tückisch	negative	-1
Tugendhaftigkeit	positive	1
tugendhaft	positive	1
tugendlich	positive	1
tumb	negative	-1
Tumorleiden	negative	-1
Tumor	negative	-1
Tumult	negative	-0.7
Turbulenz	negative	-0.7
Typhus	negative	-1
Tyrannei	negative	-1
tyrannisieren	negative	-1
übel_gesinnt	negative	-1
übelgesinnt	negative	-1
Übelkeit	negative	-1
übellaunig	negative	-1
übel	negative	-1
übel_nehmen	negative	-1
übelnehmen	negative	-1
übel_wollend	negative	-1
übelwollend	negative	-1
Überaktivität	negative	-0.7
Überängstlichkeit	negative	-1
überanstrengen	negative	-0.7
überarbeiten	negative	-0.7
überarbeitet	negative	-0.7
überbeanspruchen	negative	-1
überbelasten	negative	-0.7
überbelastet	negative	-0.7
Überbevölkerung	negative	-1
überbordend	positive	1
überdehnen	negative	-0.7
überdreht	negative	-0.7
Überdruss	negative	-1
Überdruß	negative	-1
übereifrig	negative	-0.7
übereinkommen	positive	0.7
übereinstimmend	positive	1
Überempfindlichkeit	negative	-0.7
überempfindlich	negative	-1
Überernährung	negative	-1
überfallen	negative	-1
Überfall	negative	-0.7
überfordern	negative	-0.7
überfordert	negative	-0.7
überfordert	negative	-1
Überforderung	negative	-1
übergehen	negative	-0.7
übergewichtig	negative	-0.7
Übergewicht	negative	-1
überglücklich	positive	1
Übergriff	negative	-1
überheblich	negative	-0.7
überhöht	negative	-1
überkandidelt	negative	-1
überlasten	negative	-0.7
überlastet	negative	-0.7
Überlegenheitsgefühl	negative	-1
überlegen	positive	0.7
überlegt	positive	1
Übermacht	negative	-0.7
übermäßig	negative	-1
Übermut	negative	-0.7
Übermut	positive	1
überordnen	positive	0.7
überqualifiziert	negative	-1
überragend	positive	1
überraschend	positive	0.7
überreagieren	negative	-1
Überreaktion	negative	-0.7
übersättigt	negative	-0.7
überschätzen	negative	-0.7
überschäumend	positive	1
überschnappen	negative	-1
Überschreiten	negative	-0.7
überschreiten	negative	-1
Überschreitung	negative	-0.7
Überschwang	positive	1
Überschwenglichkeit	negative	-1
überspannt	negative	-0.7
überstrapazieren	negative	-1
übertölpeln	negative	-0.7
übertreiben	negative	-0.7
übertreten	negative	-1
Übertretung	negative	-0.7
übertrieben	negative	-0.7
übertrieben	negative	-1
übervorteilen	negative	-0.7
überwältigend	positive	1
überwältigen	positive	1
überwinden	positive	0.7
überwinden	positive	1
überzeugend	positive	1
überzeugen	positive	1
überzeugt	positive	1
überzogen	negative	-1
uferlos	negative	-0.7
Ufersicherung	positive	0.7
U-Haft	negative	-1
umbringen	negative	-1
Umdeutung	positive	0.7
umfallen	negative	-0.7
umgarnen	positive	1
umgekehrt	positive	1
umgestalten	positive	0.7
Umgruppierung	positive	0.7
umkommen	negative	-0.7
Umsatzsteigerung	positive	0.7
umschmeicheln	negative	-0.7
umschmeicheln	positive	0.7
umschwärmt	positive	1
umsichtig	positive	1
umsorgen	positive	0.7
umständlich	negative	-0.7
umstritten	negative	-1
umtriebig	positive	0.7
umweltbewusst	positive	1
umweltbewußt	positive	1
Umweltfeindlichkeit	negative	-0.7
umweltfeindlich	negative	-1
Umweltfreundlichkeit	positive	0.7
umweltfreundlich	positive	1
umweltschonend	positive	1
Umweltschutzaktion	positive	0.7
Umweltschutzaktion	positive	1
Umweltverträglichkeit	positive	0.7
Umweltzerstörung	negative	-1
umwerben	positive	0.7
umwerfend	positive	1
umwerfen	positive	0.7
umworben	positive	1
Unabhängigkeit	positive	0.7
Unabhängigkeitskampf	negative	-0.7
Unabhängigkeitskrieg	negative	-1
unabhängig	positive	0.7
Unabsetzbarkeit	negative	-0.7
unakzeptabel	negative	-1
unanfechtbar	positive	0.7
unangebracht	negative	-1
unangefochten	positive	0.7
unangekündigt	negative	-0.7
unangemeldet	negative	-0.7
unangemessen	negative	-1
unangenehm	negative	-1
unangesagt	negative	-0.7
unangreifbar	positive	1
unannehmbar	negative	-1
unansehnlich	negative	-1
unansprechbar	negative	-0.7
unanständig	negative	-1
unantastbar	positive	1
unappetitlich	negative	-1
unästhetisch	negative	-1
Unattraktivität	negative	-0.7
unattraktiv	negative	-1
unaufdringlich	positive	0.7
unauffindbar	negative	-0.7
unaufmerksam	negative	-1
unaufrichtig	negative	-1
unaufspürbar	negative	-0.7
unausgebildet	negative	-0.7
Unausgeglichenheit	negative	-1
unausgeglichen	negative	-0.7
unausgegoren	negative	-1
unausgereift	negative	-1
unausgesprochen	negative	-0.7
unausgewogen	negative	-1
Unausweichlichkeit	negative	-0.7
unbändig	negative	-1
Unbarmherzigkeit	negative	-1
unbarmherzig	negative	-0.7
Unbedarftheit	negative	-1
unbedarft	negative	-0.7
Unbedenklichkeit	positive	0.7
Unbefangenheit	negative	-1
unbefangen	positive	0.7
unbefriedigend	negative	-1
unbefugt	negative	-1
unbegabt	negative	-1
unbegründet	negative	-1
Unbehagen	negative	-1
unbehaglich	negative	-1
unbeherrscht	negative	-1
Unbeholfenheit	negative	-0.7
unbeholfen	negative	-1
unbeirrbar	positive	0.7
unbekannt	negative	-0.7
Unbekümmertheit	negative	-1
Unbeliebtheit	negative	-1
unbeliebt	negative	-1
unbequem	negative	-1
Unberechenbarkeit	negative	-0.7
unberechenbar	negative	-0.7
unberechtigt	negative	-1
unbeschlagen	negative	-1
unbescholten	positive	1
unbeschwert	positive	1
unbesiegbar	positive	1
unbesiegt	positive	1
unbesonnen	negative	-1
Unbeständigkeit	negative	-1
unbestechlich	positive	1
Unbestimmtheit	negative	-1
unbestreitbar	positive	0.7
unbestritten	positive	0.7
unbewährt	negative	-1
Unbeweglichkeit	negative	-1
unbeweglich	negative	-0.7
unbewohnbar	negative	-0.7
unbezahlbar	negative	-1
unbezahlt	negative	-0.7
unbezwingbar	positive	1
Unbill	negative	-1
unblutig	positive	1
unbürokratisch	positive	0.7
Undankbarkeit	negative	-1
undankbar	negative	-1
Undank	negative	-1
undemokratisch	negative	-1
undogmatisch	positive	0.7
Undurchdringlichkeit	negative	-0.7
undurchdringlich	negative	-0.7
Unebenheit	negative	-0.7
unecht	negative	-1
unehrenhaft	negative	-1
Unehrlichkeit	negative	-1
unehrlich	negative	-1
uneigennützig	positive	1
uneingeladen	negative	-1
uneinholbar	positive	1
Uneinigkeit	negative	-0.7
uneinsichtig	negative	-0.7
uneitel	positive	0.7
Unempfindlichkeit	positive	0.7
unempfindlich	positive	1
Unendlichkeit	positive	0.7
unentschieden	negative	-0.7
unentschlossen	negative	-0.7
unentschuldbar	negative	-1
unentwegt	positive	0.7
Unerbittlichkeit	negative	-1
unerbittlich	negative	-0.7
unerfahren	negative	-1
unerfreulich	negative	-1
unergiebig	negative	-1
unerheblich	negative	-1
unerhört	negative	-1
unermüdlich	positive	0.7
unerprobt	negative	-1
unerquicklich	negative	-1
unerreichbar	positive	1
unerreicht	positive	1
unersättlich	negative	-1
unerschrocken	negative	-0.7
unerschrocken	positive	1
unerschütterlich	positive	1
unerschwinglich	negative	-1
unerträglich	negative	-1
unerwünscht	negative	-0.7
Unfähigkeit	negative	-0.7
unfähig	negative	-1
unfair	negative	-1
Unfallflucht	negative	-0.7
unfallgefährdet	negative	-0.7
Unfall	negative	-1
Unfehlbarkeit	positive	0.7
unfehlbar	positive	1
unflätig	negative	-1
unförmig	negative	-1
unfraglich	positive	0.7
Unfreiheit	negative	-1
unfrei	negative	-0.7
Unfreiwilligkeit	negative	-0.7
unfreiwillig	negative	-0.7
Unfreundlichkeit	negative	-1
unfreundlich	negative	-1
Unfruchtbarkeit	negative	-0.7
unfruchtbar	negative	-0.7
unfruchtbar	negative	-1
ungebeten	negative	-1
ungebildet	negative	-1
ungebührlich	negative	-1
Ungebundenheit	positive	0.7
ungeduldig	negative	-0.7
Ungeduld	negative	-1
ungeeignet	negative	-1
ungefährdet	positive	0.7
Ungefährlichkeit	positive	1
ungehalten	negative	-1
Ungeheuerlichkeit	negative	-1
ungeheuer	negative	-1
ungehobelt	negative	-1
Ungehörigkeit	negative	-1
ungehörig	negative	-1
ungehorsam	negative	-0.7
Ungehorsam	negative	-0.7
ungelegen	negative	-1
ungeliebt	negative	-1
ungemütlich	negative	-1
Ungenauigkeit	negative	-0.7
ungenügend	negative	-1
ungepflegt	negative	-1
ungerechtfertigt	negative	-1
Ungerechtigkeit	negative	-1
ungerecht	negative	-1
Ungeschicklichkeit	negative	-1
ungeschickt	negative	-1
ungeschlagen	positive	1
ungestört	positive	0.7
ungesund	negative	-1
Ungetrübtheit	positive	0.7
ungetrübt	positive	0.7
Ungewissheit	negative	-1
Ungewißheit	negative	-1
ungewollt	negative	-0.7
ungezähmt	negative	-0.7
ungezogen	negative	-0.7
Ungezwungenheit	positive	0.7
ungezwungen	positive	0.7
Unglaube	negative	-1
unglaubhaft	negative	-1
Ungläubigkeit	negative	-1
Unglaubwürdigkeit	negative	-0.7
unglaubwürdig	negative	-1
Ungleichgewicht	negative	-0.7
Ungleichheit	negative	-0.7
Unglücklichkeit	negative	-1
unglücklich	negative	-1
Unglück	negative	-1
Unglücksursache	negative	-0.7
ungünstig	negative	-1
Ungunst	negative	-1
ungutes_Gefühl	negative	-1
ungut	negative	-1
unhaltbar	negative	-1
Unheilbarkeit	negative	-1
unheilig	negative	-1
Unheil	negative	-1
unheilschwanger	negative	-1
unheilverheißend	negative	-1
unheilvoll	negative	-1
unheimlich	negative	-1
unhöflich	negative	-1
unintelligent	negative	-1
uninteressant	negative	-1
Uninteressiertheit	negative	-1
uninteressiert	negative	-1
Universalität	positive	0.7
unkalkulierbar	negative	-0.7
unklug	negative	-1
unkompliziert	positive	0.7
unkonzentriert	negative	-1
Unkorrektheit	negative	-0.7
Unkorrektheit	negative	-1
unkundig	negative	-1
Unlesbarkeit	negative	-0.7
unliebsam	negative	-1
unlogisch	negative	-1
Unlust	negative	-1
unmanierlich	negative	-1
unmaßgeblich	negative	-1
unmäßig	negative	-1
Unmenschlichkeit	negative	-1
unmenschlich	negative	-1
Unmöglichkeit	negative	-1
unmoralisch	negative	-1
unmotiviert	negative	-0.7
Unmündigkeit	negative	-0.7
Unmut	negative	-1
unnachahmlich	positive	1
Unnachgiebigkeit	negative	-1
Unnatürlichkeit	negative	-0.7
unnatürlich	negative	-0.7
unnützlich	negative	-1
unnütz	negative	-1
Unordentlichkeit	negative	-1
unordentlich	negative	-1
unpassend	negative	-1
Unpässlichkeit	negative	-1
Unpäßlichkeit	negative	-1
unpopulär	negative	-0.7
unpraktisch	negative	-1
unprätentiös	positive	0.7
unproduktiv	negative	-0.7
unprofessionell	negative	-1
unpünktlich	negative	-1
unqualifiziert	negative	-0.7
Unrast	negative	-1
Unrealisierbarkeit	negative	-0.7
unrealisierbar	negative	-1
unrealistisch	negative	-1
unrechtmäßig	negative	-1
unrecht	negative	-1
Unrecht	negative	-1
Unredlichkeit	negative	-1
unredlich	negative	-1
unreflektiert	negative	-1
Unregelmäßigkeit	negative	-0.7
Unreife	negative	-1
unreif	negative	-0.7
Unreinlichkeit	negative	-0.7
unrichtig	negative	-1
Unruhe	negative	-0.7
Unruhe	negative	-1
Unruhen	negative	-0.7
unruhig	negative	-1
unrühmlich	negative	-0.7
unsanft	negative	-1
Unschärfe	negative	-0.7
unschätzbar	positive	1
unscheinbar	negative	-1
unschlagbar	positive	1
unschlüssig	negative	-0.7
unschön	negative	-1
Unschuldigkeit	positive	1
unschuldig	positive	1
Unschuld	positive	1
unselbständig	negative	-1
unselbstständig	negative	-1
unselig	negative	-1
unsensibel	negative	-1
Unsicherheit	negative	-1
Unsicherheitsfaktor	negative	-0.7
unsicher	negative	-0.7
unsinnig	negative	-1
unsittlich	negative	-1
unsozial	negative	-1
unspektakulär	negative	-1
Unsterblichkeit	positive	0.7
Unstetigkeit	negative	-1
unstrittig	positive	0.7
unsympatisch	negative	-1
untalentiert	negative	-1
untätig	negative	-1
Untat	negative	-0.7
Untauglichkeit	negative	-0.7
untauglich	negative	-1
unterbelichtet	negative	-1
unterbinden	negative	-0.7
unterdrückerisch	negative	-1
Unterdrückung	negative	-0.7
unterentwickelt	negative	-0.7
unterentwickelt	negative	-1
unterernährt	negative	-0.7
Unterernährung	negative	-1
unterfordert	negative	-1
Untergewicht	negative	-1
unterhalten	positive	1
unterhaltsam	positive	1
Unterjochung	negative	-1
unterjubeln	negative	-1
unterkühlt	negative	-0.7
Unterlassungssünde	negative	-0.7
Unterlegenheit	negative	-0.7
Unterlegenheitsgefühl	negative	-1
unterlegen	negative	-0.7
unterlegt	positive	1
unterliegen	negative	-0.7
unterminieren	negative	-0.7
Unternehmensteuerreform	positive	1
Unternehmungsgeist	positive	1
unternehmungslustig	positive	0.7
Unternehmungslust	positive	1
unterordnen	negative	-0.7
unterqualifiziert	negative	-1
unterrichtet	positive	0.7
untersagen	negative	-1
unterschätzen	negative	-0.7
unterschieben	negative	-1
unterschlagen	negative	-0.7
Unterschlagung	negative	-0.7
unterschwellig	negative	-0.7
unterstellen	negative	-0.7
unterstützend	positive	1
unterstützen	positive	0.7
Untersuchungshaft	negative	-1
untertreiben	negative	-1
Unterversorgung	negative	-0.7
unterwerfen	negative	-0.7
Unterwerfung	negative	-0.7
Unterwürfigkeit	negative	-1
unterwürfig	negative	-1
untragbar	negative	-1
Untreue	negative	-1
untreu	negative	-1
untröstlich	negative	-1
untrüglich	positive	0.7
untüchtig	negative	-0.7
Untugend	negative	-1
unüberlegt	negative	-1
Unübersichtlichkeit	negative	-0.7
unumschränkt	positive	0.7
unumstößlich	positive	0.7
unumstritten	positive	0.7
unverantwortbar	negative	-1
unverantwortlich	negative	-1
unverbesserlich	negative	-1
Unverbindlichkeit	negative	-0.7
Unverbindlichkeit	negative	-1
unverblümt	positive	1
unverdächtig	positive	1
unverdient	negative	-1
unverdorben	positive	1
unverdrossen	positive	0.7
Unverfälschtheit	positive	0.7
unverfälscht	positive	1
Unverfrorenheit	negative	-1
unverfroren	negative	-1
unverfügbar	negative	-0.7
Unvergänglichkeit	positive	0.7
unvergütet	negative	-0.7
unverhältnismäßig	negative	-1
unverhohlen	negative	-0.7
Unverkäuflichkeit	negative	-0.7
unverkrampft	positive	0.7
Unverletzlichkeit	positive	0.7
unverletzt	positive	1
Unvermögen	negative	-0.7
unvernünftig	negative	-1
Unverschämtheit	negative	-1
unverschämt	negative	-1
Unversehrtheit	positive	0.7
unversehrt	positive	1
unversöhnlich	negative	-1
unverstanden	negative	-1
Unverträglichkeit	negative	-0.7
Unvertretbarkeit	negative	-0.7
unvertretbar	negative	-1
unverwundbar	positive	1
unverwüstlich	positive	0.7
unverzagt	positive	0.7
unverzeihlich	negative	-1
Unvollkommenheit	negative	-1
unvoreingenommen	positive	1
Unvorhersehbarkeit	negative	-0.7
unvorsichtig	negative	-1
Unwahrheit	negative	-1
unwahr	negative	-1
Unwesen	negative	-0.7
Unwichtigkeit	negative	-0.7
unwiderstehlich	positive	1
Unwille	negative	-1
unwillig	negative	-0.7
unwillkommen	negative	-1
unwirklich	negative	-1
Unwirksamkeit	negative	-0.7
unwirsch	negative	-1
unwissend	negative	-1
unwissentlich	negative	-0.7
Unwohlsein	negative	-1
unwürdig	negative	-0.7
unwürdig	negative	-1
Unzucht	negative	-0.7
Unzufriedenheit	negative	-1
unzufrieden	negative	-1
unzugänglich	negative	-1
Unzulänglichkeit	negative	-1
unzulänglich	negative	-1
unzumutbar	negative	-1
unzurechnungsfähig	negative	-1
unzureichend	negative	-1
unzutreffend	negative	-1
Unzuverlässigkeit	negative	-1
unzuverlässig	negative	-1
unzweckmäßig	negative	-1
unzweifelhaft	positive	0.7
Update	positive	0.7
üppig	positive	0.7
urbar	positive	0.7
urkomisch	positive	1
Urkundenfälschung	negative	-0.7
Urkundenfälschung	negative	-1
Urlaubsanspruch	positive	0.7
Urlaubsfreude	positive	1
Urlaubsgenuss	positive	1
Urlaubsgenuß	positive	1
urlaubsreif	negative	-1
Urlaubsvergnügen	positive	1
Ursprünglichkeit	positive	0.7
Urvertrauen	positive	1
Usurpation	negative	-0.7
utopisch	negative	-1
validieren	positive	1
variabel	positive	0.7
Vaterlandsliebe	positive	1
vaterlandslos	negative	-0.7
väterlich	positive	0.7
vaterlos	negative	-0.7
vegetieren	negative	-0.7
Venia_legendi	positive	1
verabreden	positive	0.7
verabscheuen	negative	-1
verabscheuungswürdig	negative	-1
verachten	negative	-1
verachtet	negative	-1
verächtlich	negative	-1
Verachtung	negative	-1
veralbern	negative	-1
verängstigt	negative	-1
verantworten	negative	-0.7
verantworten	positive	1
Verantwortung	positive	1
verantwortungsbewusst	positive	1
verantwortungsbewußt	positive	1
Verantwortungsgefühl	positive	1
Verantwortungslosigkeit	negative	-1
verantwortungslos	negative	-1
verantwortungsvoll	positive	1
veräppeln	negative	-1
verargen	negative	-1
verärgern	negative	-1
verärgert	negative	-1
Verärgerung	negative	-1
verarmen	negative	-0.7
verarmt	negative	-0.7
verarschen	negative	-0.7
verausgaben	negative	-0.7
Verausgabung	negative	-1
verballhornen	negative	-1
Verballhornung	negative	-0.7
verbannen	negative	-1
verbeißen	negative	-1
verbessern	positive	0.7
Verbesserung	positive	0.7
Verbesserungsvorschlag	positive	0.7
verbieten	negative	-1
Verbindlichkeit	positive	1
verbittert	negative	-1
Verbitterung	negative	-1
Verbleib	positive	0.7
verblendet	negative	-1
verblichen	negative	-1
verblüffend	positive	0.7
verblüffen	positive	1
verbluten	negative	-1
verbockt	negative	-1
verborgen	negative	-0.7
verbrämen	negative	-1
verbraucht	negative	-1
Verbrechen	negative	-0.7
Verbrechensrate	negative	-1
verbrecherisch	negative	-1
verbrennen	negative	-0.7
Verbrennung	negative	-0.7
verbriefen	positive	0.7
Verbrüderung	positive	0.7
verbrühen	negative	-1
verbummeln	negative	-0.7
Verbundenheit	positive	0.7
Verbundenheitsgefühl	positive	1
verbünden	positive	0.7
verbürgen	positive	0.7
Verbüßung	positive	0.7
verdächtigen	negative	-0.7
verdächtigen	negative	-1
verdächtig	negative	-1
verdammen	negative	-1
Verdammnis	negative	-1
Verdammung	negative	-1
verdauen	positive	0.7
Verdauungsbeschwerden	negative	-1
Verdauungsstörung	negative	-1
verdeckt	negative	-0.7
verderben	negative	-1
verdeutlichen	positive	0.7
verdienstvoll	positive	1
verdient	positive	1
verdonnern	negative	-1
verdorben	negative	-1
verdorren	negative	-0.7
verdrängen	positive	0.7
Verdrängung	negative	-0.7
verdrehen	negative	-0.7
verdrießen	negative	-1
verdrießlich	negative	-1
Verdrossenheit	negative	-1
verdrossen	negative	-1
verdruckst	negative	-0.7
Verdruß	negative	-1
verdursten	negative	-1
verehren	positive	1
verehrt	positive	1
Verehrung	positive	1
verehrungswürdig	positive	1
vereinsamt	negative	-0.7
Vereinsamung	negative	-0.7
Vereinsgründung	positive	0.7
vereinzelt	negative	-0.7
vereiteln	negative	-0.7
vereitert	negative	-1
verelenden	negative	-1
verenden	negative	-0.7
verfallen	negative	-0.7
verfälschen	negative	-1
verfassungsfeindlich	negative	-1
Verfassungsgemäßigkeit	positive	0.7
verfassungsgemäß	positive	1
verfassungskonform	positive	1
Verfassungsreform	positive	1
verfassungstreu	positive	1
verfehlen	negative	-0.7
verfehlt	negative	-1
Verfehlung	negative	-0.7
verfeindet	negative	-1
Verfemung	negative	-1
Verfestigung	positive	1
verfluchen	negative	-1
verfolgen	negative	-1
Verfolgung	negative	-0.7
Verfolgungswahn	negative	-1
verformt	negative	-1
verfressen	negative	-1
Verfügungsgewalt	negative	-0.7
verführbar	negative	-0.7
verführen	negative	-1
vergällen	negative	-1
vergammeln	negative	-0.7
vergammelt	negative	-1
Vergänglichkeit	negative	-0.7
Vergasung	negative	-0.7
vergeben	positive	0.7
Vergeblichkeit	negative	-1
Vergebung	positive	0.7
vergehen	negative	-0.7
Vergehen	negative	-0.7
vergehen	negative	-1
vergelten	negative	-0.7
vergelten	negative	-1
Vergeltung	negative	-1
Vergeltungsmaßnahme	negative	-0.7
Vergeltungsmaßnahme	negative	-1
Vergeltungsschlag	negative	-0.7
Vergeltungsschlag	negative	-1
vergessen	negative	-0.7
vergesslich	negative	-1
vergeßlich	negative	-1
vergewaltigen	negative	-1
Vergewaltigung	negative	-0.7
vergießen	negative	-1
Vergiftung	negative	-1
vergnügen	positive	1
Vergnügen	positive	1
vergnüglich	positive	0.7
Vergnügtheit	positive	1
vergnügt	positive	1
vergnügungssüchtig	negative	-0.7
Vergoldung	positive	0.7
vergönnen	positive	1
vergöttern	positive	1
vergöttert	positive	1
Vergötterung	positive	1
vergrämt	negative	-1
vergrätzen	negative	-1
vergrätzt	negative	-1
vergraulen	negative	-1
Verhaftung	negative	-0.7
verhalten	negative	-1
verhaltensgestört	negative	-1
Verhaltenstherapie	positive	0.7
verhandlungsfähig	positive	0.7
Verhandlungsspielraum	positive	0.7
verhängnisvoll	negative	-1
verharmlosen	negative	-1
verhärtet	negative	-1
Verhärtung	negative	-1
verhasst	negative	-1
verhaßt	negative	-1
verhätschelt	negative	-0.7
verheerend	negative	-1
verheilt	positive	1
verheimlichen	negative	-0.7
Verheimlichung	negative	-0.7
verheißen	positive	0.7
verheißungsvoll	positive	1
verhelfen	positive	0.7
verherrlichen	positive	1
Verhetzung	negative	-0.7
verhexen	negative	-1
verhindern	negative	-1
verhindert	negative	-0.7
verhohnepipeln	negative	-1
Verhöhnung	negative	-1
Verhüllung	negative	-0.7
Verhüllung	negative	-1
verhungern	negative	-1
Verhungerung	negative	-1
Verhütung	positive	0.7
Verjüngungskur	positive	0.7
verkalkulieren	negative	-0.7
Verkalkung	negative	-1
Verkehrschaos	negative	-0.7
Verkehrsdelikt	negative	-0.7
Verkehrslärm	negative	-0.7
Verkehrssicherheit	positive	0.7
verkehrssicher	positive	1
verkehrstauglich	positive	1
verkehrsuntauglich	negative	-1
verkehrt	positive	1
verkennen	negative	-0.7
verklagen	negative	-1
verklauseln	positive	0.7
verklausulieren	positive	0.7
verklemmt	negative	-0.7
verknacken	negative	-1
verknacksen	negative	-0.7
verknallt	positive	0.7
verkneifen	negative	-1
verkniffen	negative	-0.7
verknusen	negative	-0.7
verkohlen	negative	-0.7
Verkommenheit	negative	-1
verkommen	negative	-1
verkorkst	negative	-1
verkraften	negative	-0.7
verkrampft	negative	-0.7
Verkrampfung	negative	-1
verkrüppelt	negative	-0.7
Verkrüppelung	negative	-1
verkühlen	negative	-1
verkümmern	negative	-0.7
verlachen	negative	-1
verladen	negative	-0.7
Verlassenheit	negative	-1
verlassen	negative	-0.7
Verlässlichkeit	positive	1
verlässlich	positive	1
verläßlich	positive	1
verlebt	negative	-1
Verlegenheit	negative	-1
verleiden	negative	-1
verlernen	negative	-0.7
Verletzbarkeit	negative	-0.7
verletzbar	negative	-1
verletzend	negative	-1
verletzen	negative	-1
Verletzlichkeit	negative	-0.7
verletzt	negative	-0.7
verletzt	negative	-1
Verletzung	negative	-0.7
Verletzung	negative	-1
verletzungsfrei	positive	0.7
Verleugnung	negative	-0.7
verleumden	negative	-1
verlieben	positive	1
Verliebtheit	positive	1
verliebt	positive	1
Verliebtsein	positive	1
verlieren	negative	-0.7
Verliererseite	negative	-0.7
Verlobung	positive	0.7
verlockend	positive	1
verlocken	negative	-1
Verlogenheit	negative	-1
verlogen	negative	-1
verloren_gegangen	negative	-0.7
verlorengegangen	negative	-0.7
Verlorenheit	negative	-0.7
verloren	negative	-0.7
verlottern	negative	-1
verlottert	negative	-1
verlumpt	negative	-1
verlustbringend	negative	-1
Verlust_bringend	negative	-1
verlustfrei	positive	0.7
Verlust	negative	-1
verlustreich	negative	-1
Vermählung	positive	0.7
vermaledeien	negative	-1
vermasseln	negative	-0.7
Vermeidung	negative	-0.7
vermeintlich	negative	-1
vermiesen	negative	-1
vermisst	negative	-0.7
vermißt	negative	-0.7
vermögend	positive	0.7
Vermögen	positive	0.7
Vermögenswert	positive	0.7
vermurkst	negative	-1
vernachlässigen	negative	-1
verneinen	negative	-1
vernichtend	negative	-1
Vernichten	negative	-1
Vernichtung	negative	-1
Vernichtungskrieg	negative	-1
verniedlichen	negative	-1
vernünftig	positive	1
Vernunft	positive	1
veröden	negative	-0.7
verpacken	negative	-0.7
verpassen	negative	-0.7
verpennen	negative	-0.7
verpetzen	negative	-1
verpfeifen	negative	-1
verpflichten	positive	1
verpönen	negative	-1
verpönt	negative	-1
verprellen	negative	-1
verquer	negative	-0.7
verraten	negative	-0.7
verraten	negative	-1
Verrat	negative	-1
verrucht	negative	-1
verrückt	negative	-1
verrufen	negative	-1
versagen	negative	-0.7
versagen	negative	-1
versauen	negative	-0.7
versauen	negative	-1
versäumen	negative	-0.7
verschämt	negative	-0.7
verschärft	negative	-0.7
Verschärfung	negative	-0.7
verschätzen	negative	-0.7
verschaukeln	negative	-0.7
verscheiden	negative	-0.7
verscheißern	negative	-0.7
verscheißern	negative	-1
verschieden	negative	-1
verschießen	negative	-1
verschlafen	negative	-0.7
Verschlagenheit	negative	-1
verschlagen	negative	-1
verschlechtern	negative	-0.7
Verschlechterung	negative	-1
Verschleierung	negative	-0.7
Verschleierung	negative	-1
verschleimt	negative	-1
Verschleiß	negative	-1
Verschleppung	negative	-0.7
verschließen	negative	-0.7
Verschlossenheit	negative	-0.7
verschlossen	negative	-1
verschmähen	negative	-0.7
verschmerzen	positive	1
verschmitzt	positive	0.7
verschnupft	negative	-1
verschollen	negative	-0.7
Verschönerung	positive	0.7
verschorft	negative	-1
verschossen	positive	0.7
verschrecken	negative	-1
verschreckt	negative	-1
verschrien	negative	-1
Verschrobenheit	negative	-0.7
verschroben	negative	-1
Verschrottung	negative	-1
verschüchtert	negative	-0.7
Verschulden	negative	-1
Verschuldung	negative	-0.7
verschusseln	negative	-0.7
Verschweigen	negative	-0.7
verschweigen	negative	-1
verschwenderisch	negative	-0.7
Verschwiegenheit	positive	0.7
verschwiegen	positive	1
Verschwisterung	positive	0.7
verschwitzen	negative	-0.7
verschwitzt	negative	-1
verschwören	negative	-0.7
verschwörerisch	negative	-0.7
verschwunden	negative	-0.7
versehren	negative	-1
versehrt	negative	-1
versetzen	negative	-0.7
versichern	positive	1
Versicherungsbetrug	negative	-0.7
Versicherungsbetrug	negative	-1
versieben	negative	-0.7
Versiegelung	positive	0.7
Versieglung	positive	0.7
versiert	positive	1
versklaven	negative	-1
Versklavung	negative	-1
verslumen	negative	-1
versnobt	negative	-0.7
versoffen	negative	-1
versöhnen	positive	0.7
versöhnlich	positive	1
Versöhnung	positive	1
Versorgungssicherheit	positive	0.7
Verspannung	negative	-0.7
verspäten	negative	-0.7
versprechen	positive	0.7
versprechen	positive	1
verständigen	positive	0.7
verständig	positive	1
verständnislos	negative	-0.7
verständnisvoll	positive	1
verstauchen	negative	-0.7
Verstauchung	negative	-0.7
Versteckspiel	negative	-0.7
Versteckspiel	negative	-1
versteckt	negative	-0.7
versterben	negative	-0.7
verstimmen	negative	-1
verstimmt	negative	-1
Verstimmung	negative	-1
verstockt	negative	-1
verstohlen	negative	-1
Verstopfung	negative	-1
verstorben	negative	-1
verstören	negative	-1
Verstörung	negative	-1
verstoßen	negative	-1
Verstoß	negative	-0.7
verstümmeln	negative	-1
Verstümmelung	negative	-1
Verstümmlung	negative	-1
versumpfen	negative	-1
versüßen	positive	0.7
vertauschen	negative	-0.7
verteidigen	positive	1
Verteidigung	positive	0.7
Verteidigungskrieg	negative	-1
Verteilungskampf	negative	-0.7
Verteuerung	positive	0.7
verteufeln	negative	-1
vertragen	positive	0.7
Vertragsbruch	negative	-0.7
Vertragstreue	positive	0.7
vertrauenerweckend	positive	1
Vertrauen_erweckend	positive	1
Vertrauen	positive	1
vertrauensbildend	positive	1
Vertrauensbruch	negative	-1
vertrauenserweckend	positive	1
vertrauensfördernd	positive	1
Vertrauenskrise	negative	-1
Vertrauensstellung	positive	0.7
Vertrauensverhältnis	positive	0.7
Vertrauensverlust	negative	-1
vertrauensvoll	positive	1
Vertrauenswürdigkeit	positive	0.7
vertrauenswürdig	positive	1
Vertraulichkeit	positive	0.7
verträumt	negative	-0.7
Vertrautheit	positive	1
vertrocknen	negative	-0.7
Vertuschung	negative	-0.7
verübeln	negative	-1
verüben	negative	-1
verundeutlichen	negative	-1
verunglimpfen	negative	-1
verunklaren	negative	-1
verunmöglichen	negative	-0.7
Verunsichern	negative	-1
verunsichert	negative	-0.7
Verunsicherung	negative	-1
verurteilen	negative	-1
Verve	positive	1
vervollkommnen	positive	0.7
Vervollkommnung	positive	0.7
verwachsen	negative	-1
verwahrlosen	negative	-1
verwahrlost	negative	-1
Verwahrlosung	negative	-1
verwaisen	negative	-0.7
Verwaltungsreform	positive	1
verwarnen	negative	-1
Verwarnung	negative	-1
verwechseln	negative	-0.7
verwehren	negative	-1
verweigern	negative	-1
Verweis	negative	-1
verwerfen	negative	-0.7
Verwerflichkeit	negative	-1
verwerflich	negative	-1
Verwertbarkeit	positive	0.7
verwesen	negative	-0.7
verwestlichen	negative	-1
verwirrend	negative	-1
verwirren	negative	-1
Verwirrspiel	negative	-1
verwirrt	negative	-1
Verwirrung	negative	-1
verwitwen	negative	-0.7
verwöhnt	negative	-0.7
verworfen	negative	-1
verwundbar	negative	-1
verwunden	negative	-1
verwundern	negative	-1
verwundet	negative	-1
Verwundung	negative	-1
verwünschen	negative	-1
Verwurzelung	positive	0.7
Verwüstung	negative	-1
verzagen	negative	-1
Verzagtheit	negative	-1
verzagt	negative	-1
verzärtelt	negative	-0.7
verzaubern	positive	1
verzaubert	positive	0.7
verzeihend	positive	0.7
verzeihen	positive	0.7
Verzeihung	positive	0.7
verzogen	negative	-0.7
verzücken	positive	1
verzückt	positive	1
Verzückung	positive	1
verzweifeln	negative	-1
verzweifelt	negative	-1
Verzweiflung	negative	-1
Verzweiflungshandlung	negative	-1
Verzweiflungstat	negative	-1
Vetternwirtschaft	negative	-0.7
Vetternwirtschaft	negative	-1
vielbeschworen	positive	0.7
vielfältig	positive	0.7
vielgepriesen	positive	1
Vielseitigkeit	positive	0.7
vielseitig	positive	1
vielversprechend	positive	1
Vietnamkrieg	negative	-1
virtuos	positive	1
Virusgrippe	negative	-1
Virusinfektion	negative	-1
vital	positive	0.7
vogelfrei	negative	-0.7
Völkerfreundschaft	positive	0.7
Völkermord	negative	-0.7
Völkermord	negative	-1
Volksaufstand	negative	-0.7
Volksverhetzung	negative	-0.7
Völlegefühl	negative	-0.7
Völlerei	negative	-1
voll_gefressen	negative	-0.7
vollgefressen	negative	-0.7
voll_gestopft	negative	-0.7
vollgestopft	negative	-0.7
Vollkommenheit	positive	1
vollmundig	negative	-0.7
Vollrausch	negative	-1
vollschlank	positive	0.7
voll_spucken	negative	-0.7
vollspucken	negative	-0.7
vollstopfen	negative	-0.7
vollstramm	negative	-1
volltrunken	negative	-1
Vollzug	negative	-1
voluminös	negative	-0.7
voranstellen	positive	0.7
vorarbeiten	positive	0.7
vorbelastet	negative	-0.7
vorbestimmt	positive	1
vorbestraft	negative	-0.7
vorbeugend	positive	0.7
vorbeugen	positive	0.7
Vorbildfunktion	positive	0.7
vorbildlich	positive	1
vordergründig	negative	-1
vorenthalten	negative	-0.7
vorflunkern	negative	-1
Vorfreude	positive	1
vorgaukeln	negative	-0.7
vorgeben	negative	-0.7
vorgeben	negative	-1
vorgeblich	negative	-1
vorgeschoben	negative	-1
vorgetäuscht	negative	-1
Vorhaltung	negative	-1
Vorhersehbarkeit	positive	0.7
vorheucheln	negative	-1
vorknöpfen	negative	-0.7
vorlaut	negative	-1
Vorliebe	positive	1
vorlieb_nehmen	positive	1
vorliebnehmen	positive	1
vorlügen	negative	-1
vormachen	negative	-0.7
vornehmen	negative	-0.7
vornehm	positive	0.7
Vorratsdüngung	positive	0.7
Vorsätzlichkeit	negative	-0.7
vorschieben	negative	-1
vorschreiben	negative	-0.7
vorschriftsmäßig	positive	1
vorschützen	negative	-0.7
vorschwindeln	negative	-0.7
vorsichtig	positive	0.7
Vorsorgekur	positive	0.7
vorsorglich	positive	0.7
vorspiegeln	negative	-0.7
Vorspiegelung	negative	-0.7
Vorspiegelung	negative	-1
vorspielen	negative	-0.7
Vorstrafe	negative	-1
vortäuschen	negative	-1
Vorteil	positive	0.7
Vorteilsnahme	negative	-0.7
Vorteilsnahme	negative	-1
vortrefflich	positive	1
Vortritt	positive	0.7
vorurteilsfrei	positive	1
vorurteilslos	positive	1
vorverurteilen	negative	-1
vorwerfen	negative	-1
Vorwurf	negative	-1
vorwurfsvoll	negative	-1
vorzeigbar	positive	1
vorziehen	positive	0.7
vorzüglich	positive	1
Vorzug	positive	0.7
Voyeurismus	negative	-1
vulgär	negative	-1
Vulkanausbruch	negative	-1
wach	positive	0.7
Wachstumsquote	positive	0.7
Wachstumsrate	positive	0.7
wacker	positive	1
Waffenembargo	negative	-0.7
Waffenembargo	negative	-1
Waffengeschäft	negative	-0.7
Waffengewalt	negative	-0.7
Waffenhandel	negative	-0.7
Waffenreduktion	positive	0.7
Waffenschmuggel	negative	-0.7
wagemutig	positive	0.7
wagen	positive	0.7
waghalsig	positive	0.7
wahlberechtigt	positive	1
Wahlbetrug	negative	-0.7
Wahlbetrug	negative	-1
Wahlfälschung	negative	-0.7
Wahlfälschung	negative	-1
Wahn	negative	-1
wahnsinnig	negative	-1
Wahnvorstellung	negative	-1
Wahrhaftigkeit	positive	1
wahrhaftig	positive	1
wahrhaft	positive	1
Wahrheit	positive	1
wahrheitsgemäß	positive	1
wahr	positive	1
Wahrung	positive	0.7
Währungsreform	positive	1
Wandlungsfähigkeit	positive	0.7
wandlungsfähig	positive	1
Wankelmütigkeit	negative	-1
wankelmütig	negative	-0.7
Wankelmut	negative	-1
Wärmeverlust	negative	-1
warnen	negative	-0.7
Warnstreik	negative	-0.7
Wassermangel	negative	-1
Wechselbad	positive	0.7
Wechselfieber	negative	-1
wegekeln	negative	-1
Wegfall	negative	-1
wegloben	negative	-0.7
Wegrationalisierung	negative	-0.7
wegschicken	negative	-0.7
wegstecken	positive	0.7
wegweisend	positive	1
wegwünschen	negative	-1
Wehe	negative	-1
wehklagen	negative	-1
Wehleidigkeit	negative	-1
wehmütig	negative	-1
Wehmut	negative	-1
weh	negative	-1
Weh	negative	-1
wehrdienstfahig	positive	0.7
wehren	negative	-1
wehrlos	negative	-0.7
wehrtauglich	positive	0.7
wehruntauglich	negative	-1
Wehwehchen	negative	-0.7
weichen	positive	0.7
weigern	negative	-1
weihen	negative	-0.7
weinen	negative	-1
Weinerlichkeit	negative	-1
Weinkrampf	negative	-1
weise	positive	1
Weisheit	positive	1
weismachen	negative	-0.7
weisungsbefugt	positive	1
Weiterbildung	positive	1
Weiterverwendung	positive	0.7
weitgereist	positive	1
weitschweifig	negative	-0.7
Weitsichtigkeit	negative	-0.7
weitsichtig	negative	-0.7
weitsichtig	positive	1
Wellnesskur	positive	0.7
Wellness	positive	1
weltfremd	negative	-1
Weltfrieden	positive	1
weltgewandt	positive	0.7
Weltklasse	positive	0.7
Weltkrieg	negative	-1
Weltkulturerbe	positive	0.7
Weltkulturschatz	positive	0.7
weltmännisch	positive	1
Weltniveau	positive	0.7
Weltoffenheit	positive	1
weltoffen	positive	1
Weltrang	positive	0.7
Weltschmerz	negative	-1
Weltspitze	positive	0.7
Weltuntergangsstimmung	negative	-1
Weltwunder	positive	0.7
wendig	positive	0.7
wenig	negative	-0.7
Werksspionage	negative	-0.7
Wermutstropfen	negative	-1
Werterhaltung	positive	0.7
wertgestellt	positive	0.7
Wertherstimmung	negative	-1
Wertlosigkeit	negative	-1
wertlos	negative	-0.7
wertschätzen	positive	1
wertvoll	positive	1
Wesensverwandtschaft	positive	1
Wettbewerbsfähigkeit	positive	0.7
wettbewerbsfähig	positive	1
wettern	negative	-1
Wettrüsten	negative	-1
wichtig	positive	0.7
widerlich	negative	-1
Widernatürlichkeit	negative	-0.7
widerrufen	negative	-1
Widersinnigkeit	negative	-1
Widerspenstigkeit	negative	-1
widerspenstig	negative	-0.7
widersprechen	negative	-1
Widersprüchlichkeit	negative	-1
Widerspruch	negative	-0.7
Widerstandsfähigkeit	positive	0.7
widerstandsfähig	positive	1
Widerstandskraft	positive	0.7
widerstandslos	negative	-1
widerstrebend	negative	-0.7
widerwärtig	negative	-1
Widerwille	negative	-1
widerwillig	negative	-0.7
widmen	negative	-0.7
widrig	negative	-1
Wiederaufarbeitung	positive	0.7
Wiederaufbau	positive	1
Wiederaufstieg	positive	0.7
Wiederbeschaffung	positive	0.7
Wiedererlangung	positive	0.7
Wiedergutmachung	positive	0.7
Wiederherstellung	positive	1
Wiederverwendung	positive	0.7
Wildheit	negative	-0.7
wild	negative	-0.7
wild	negative	-1
willenlos	negative	-1
Willenskraft	positive	1
Willensstärke	positive	1
willig	positive	0.7
willkommen	positive	1
Willkürakt	negative	-1
wimmern	negative	-1
Windpocken	negative	-1
winseln	negative	-1
winzig	negative	-0.7
Wirbel	negative	-0.7
wirklichkeitsfremd	negative	-1
wirklich	positive	1
Wirkungslosigkeit	negative	-0.7
wirkungslos	negative	-0.7
Wirren	negative	-0.7
Wirrwarr	negative	-0.7
Wirtschaftsaufschwung	positive	0.7
Wirtschaftsblockade	negative	-0.7
Wirtschaftsboykott	negative	-0.7
Wirtschaftsebargo	negative	-0.7
Wirtschaftsebargo	negative	-1
Wirtschaftskriminalität	negative	-0.7
Wirtschaftsreform	positive	1
Wirtschaftssanktion	negative	-0.7
Wirtschaftssanktion	negative	-1
Wirtschaftsspionage	negative	-0.7
Wirtschaftswachstum	positive	0.7
Wissbegierde	positive	0.7
Wißbegierde	positive	0.7
wißbegierig	positive	1
Wissbegier	positive	0.7
Wißbegier	positive	0.7
wissensdurstig	positive	1
Wissensdurst	positive	1
Wissenshungrigkeit	positive	0.7
witzig	positive	1
Witz	positive	1
Wochenendarrest	negative	-1
Wohlbefinden	positive	1
wohlerzogen	positive	0.7
Wohlfühlkur	positive	0.7
wohl_geformt	positive	1
wohlgeformt	positive	1
Wohlgefühl	positive	1
wohlgesinnt	positive	0.7
wohlgesonnen	positive	0.7
Wohlgestaltetheit	positive	0.7
wohlhabend	positive	0.7
wohlig	positive	0.7
wohlmeinend	positive	0.7
Wohl	positive	0.7
Wohl	positive	1
Wohlstand	positive	1
Wohlstandsgefälle	negative	-0.7
Wohltätigkeit	positive	1
Wohltätigkeitsveranstaltung	positive	0.7
Wohltat	positive	0.7
wohltuend	positive	0.7
wohl_tun	positive	0.7
wohltun	positive	0.7
wohlwollend	positive	1
wohnungslos	negative	-1
wolkenlos	positive	0.7
Wollust	negative	-1
Wonne	positive	1
Wortbruch	negative	-1
Wortfindungsstörung	negative	-1
Wortgefecht	negative	-0.7
wortgewaltig	positive	1
wortgewandt	positive	1
wortreich	positive	1
Wucherung	negative	-1
Wunde	negative	-0.7
wunderbar	positive	1
wunderschön	positive	1
wundervoll	positive	1
Wundmal	negative	-1
wund	negative	-1
Wundrose	negative	-0.7
Wundstarrkrampf	negative	-1
würdelos	negative	-0.7
würdelos	negative	-1
würdevoll	positive	0.7
würdigen	positive	1
würdig	positive	0.7
würdig	positive	1
wurmen	negative	-1
wurstig	negative	-0.7
wüst	negative	-1
Wutanfall	negative	-1
Wutausbruch	negative	-1
wütend	negative	-1
wüten	positive	1
Wut	negative	-1
zagen	negative	-0.7
zaghaft	negative	-0.7
Zähigkeit	positive	0.7
zahlreich	positive	0.7
zahlungskräftig	positive	0.7
Zahlungsunfähigkeit	negative	-0.7
zahlungsunfähig	negative	-0.7
zähmen	positive	1
zahm	positive	0.7
Zahnausfall	negative	-1
zäh	negative	-0.7
zähneknirschend	negative	-0.7
Zahnentzündung	negative	-1
Zahnerkrankung	negative	-1
Zahnfäule	negative	-1
Zahnfleischschwund	negative	-1
Zahngeschwür	negative	-1
Zahnhalsentzündung	negative	-1
Zahnkrankheit	negative	-1
Zahnschmerz	negative	-1
Zahnvereiterung	negative	-1
Zahnweh	negative	-1
Zankapfel	negative	-0.7
zänkisch	negative	-1
Zank	negative	-0.7
zanksüchtig	negative	-1
zart_besaitet	negative	-1
zartbesaitet	negative	-1
Zartheit	negative	-0.7
Zärtlichkeit	positive	1
zärtlich	positive	1
zart	positive	0.7
zauberhaft	positive	1
zauderhaft	negative	-1
zaudern	negative	-0.7
Zeckenstich	negative	-0.7
zeihen	negative	-1
Zeitverlust	negative	-1
zelebrieren	positive	0.7
Zensur	negative	-0.7
zerbeult	negative	-0.7
Zerbrechlichkeit	negative	-0.7
zeremoniell	positive	0.7
zerfallen	negative	-0.7
Zerfall	negative	-1
Zerissenheit	negative	-1
Zerlegung	negative	-1
zermürben	negative	-0.7
Zerrissenheit	negative	-1
zerrütten	negative	-0.7
Zerschlagenheit	negative	-0.7
Zerschlagung	negative	-1
zerschrammen	negative	-0.7
zerstörerisch	negative	-1
Zerstörung	negative	-1
Zerstörungswut	negative	-1
zerstreut	negative	-1
Zerstrittenheit	negative	-1
Zerstückelung	negative	-1
Zertrümmerung	negative	-1
Zerwürfnis	negative	-1
zetern	negative	-1
zeugungsfähig	positive	0.7
zeugungsunfähig	negative	-0.7
zicken	negative	-1
zickig	negative	-0.7
ziehen	negative	-0.7
zielbewusst	positive	0.7
zielbewußt	positive	0.7
zielgerichtet	positive	1
zielgesteuert	positive	0.7
ziellos	negative	-1
zielorientiert	positive	0.7
zielsicher	positive	1
Zielstrebigkeit	positive	1
zielstrebig	positive	0.7
ziepen	negative	-0.7
Zigarettenabhängigkeit	negative	-1
zig	positive	0.7
zimperlich	negative	-1
Zinserhöhung	positive	0.7
zittern	negative	-0.7
Zivilcourage	positive	1
Zivilschlag	negative	-0.7
Zivilschlag	negative	-1
Zoff	negative	-1
zögerlich	negative	-1
zögern	negative	-0.7
zollen	positive	1
zornig	negative	-1
Zorn	negative	-1
zubilligen	positive	0.7
Züchtigung	negative	-1
Zuchtlosigkeit	negative	-1
Zuckerkrankheit	negative	-1
zuckerkrank	negative	-1
Zufälligkeit	negative	-0.7
zufrieden_geben	positive	1
zufriedengeben	positive	1
Zufriedenheit	positive	1
zufrieden	positive	1
zufrieden_sein	positive	1
zufriedenstellend	positive	1
zufrieden_stellen	positive	0.7
zufriedenstellen	positive	0.7
zufügen	negative	-0.7
zugeben	positive	0.7
Zugehörigkeitsgefühl	positive	1
zugeknöpft	negative	-0.7
Zügellosigkeit	negative	-1
zügellos	negative	-0.7
zügellos	negative	-1
zügeln	positive	1
zugestehen	positive	0.7
Zugzwang	negative	-0.7
Zuhälterei	negative	-1
Zukunftsangst	negative	-1
zukunftsträchtig	positive	1
zukunftsweisend	positive	1
zulassen	positive	1
Zulässigkeit	positive	0.7
Zulassung	positive	0.7
Zumutung	negative	-1
Zuneigung	positive	1
zünftig	positive	0.7
zuraten	positive	1
zurechnungsfähig	positive	1
zurechtstutzen	negative	-1
zurechtweisen	negative	-1
Zurechtweisung	negative	-1
Zureden	positive	1
zürnen	negative	-1
Zurschaustellung	negative	-1
zurückgeblieben	negative	-0.7
Zurückgezogenheit	negative	-0.7
zurückgezogen	negative	-0.7
zurückhalten	positive	1
zurückscheuen	negative	-1
zurückschrecken	negative	-1
zurückstecken	positive	0.7
zurückweisend	negative	-1
zurückweisen	negative	-0.7
zusagen	positive	1
zusammenbrechen	negative	-0.7
Zusammenbruch	negative	-1
Zusammengehörigkeit	positive	0.7
Zusammengehörigkeitsgefühl	positive	1
zusammenkrümmen	negative	-1
zusammenrotten	negative	-1
zusammenstauchen	negative	-1
Zusatzausbildung	positive	1
zusätzlich	negative	-0.7
zusetzen	negative	-1
zusichern	positive	1
Zuspitzung	negative	-0.7
Zuspruch	positive	1
zustehend	positive	1
zustimmen	positive	0.7
zutrauen	positive	0.7
Zutrauen	positive	1
zutreffend	positive	1
Zuverlässigkeit	positive	1
zuverlässig	positive	1
zuversichtlich	positive	1
Zuversicht	positive	1
zuversichtslos	negative	-1
Zuvertrauen	positive	1
zuvorkommend	positive	0.7
Zuwendung	positive	0.7
zuwiderhandeln	negative	-1
Zuwiderhandlung	negative	-0.7
zuwider_sein	negative	-1
Zwanghaftigkeit	negative	-1
zwanghaft	negative	-1
Zwanglosigkeit	positive	0.7
Zwang	negative	-0.7
Zwangsarbeit	negative	-1
zwangsgestört	negative	-1
Zwangsvereinigung	negative	-1
Zweckentfremdung	negative	-0.7
zweckfrei	negative	-1
zwecklos	negative	-1
Zweckmäßigkeit	positive	0.7
zweckmäßig	positive	1
Zweifelhaftigkeit	negative	-0.7
zweifelhaft	negative	-0.7
zweifelhaft	negative	-1
zweifelnd	negative	-1
Zweifel	negative	-1
zweifeln	negative	-0.7
Zweifelsfall	negative	-1
Zweikampf	negative	-0.7
Zwergenaufstand	negative	-0.7
zwergenhaft	negative	-0.7
Zwietracht	negative	-1
zwingen	negative	-1
Zwischenruf	negative	-0.7
Zwischenspeicherung	positive	0.7
Zwist	negative	-0.7
zynisch	negative	-1
